Paaneach Raza, Shemot 1	@שמות פרשת שמות	NULL
Paaneach Raza, Shemot 2	ובעזרת האל בתעצומות, נתחיל ספר וסדר ואלה שמות:	NULL
Paaneach Raza, Shemot 3	ואלה" שמות" בני" ישראל", ס"ת תהי"ל לומר שלבסוף יהיל אורם אור הגאולה בזכות ואלה שמות שלא שינו את שמם כדאיתא במדרש, שמות יש בו אותיות שמת"ו, כלומר אף על גב שמנאם בחיים חזר ומנאן לאחר מותן, "שמות "בני "ישראל "הבאים ר"ת שבי"ה, לומר שאז כשמת יוסף וכל הדור ההוא הי' ראש שבים וגלותם, לכן בא הרמז בר"ת:	Exodus 1:1
Paaneach Raza, Shemot 4	ויישם בארון במצרים וסמיך לי' ואלה שמות, מכאן רמז שעושין מצבות וכותבין שם המת על קברו, מהר"ר חיים:	Exodus 1:1
Paaneach Raza, Shemot 5	הבאי"ם בגימט' ח"ן "ישראל" "הבאים", ר"ת וס"ת מיל"ה, את" יעקב" איש", ס"ת שב"ת, להורות כי בזכות שבת ומילה מצאו חן בעיני ממ"ה וגאלם, לוי:	Exodus 1:1
Paaneach Raza, Shemot 6	איש וביתו באו, במדרש אמרו שלכולם היו נשים, שאפי' חצרון וחמול שהיו קטנים שידך להם נשים כדי שלא יתחתנו במצרים והוא שגרמה להם ששיעבדו בהם כל כך ולא ריחמו עליהם, מרבי:	Exodus 1:1-2
Paaneach Raza, Shemot 7	שבעים נפש, ג"פ כתיב עליהם שבעים נפש נגד רד"ו שנה שהיו במצרים, כי ג"פ שבעים עולה רד"ו, נפש בא"ת ב"ש טו"ב:	Exodus 1:5
Paaneach Raza, Shemot 8	נפ"ש בגימט' ת"ל כנגד ומושב ב"י וגו' ארבע מאות ושלשים וגו':	NULL
Paaneach Raza, Shemot 9	ובני ישראל פרו וגו', פירש"י ששה בכרס א', מפי אבן עזרא משום ו' חדרים שברחם אשה בימין ובשמאל שנתברכו וקלטו כולם כא', והשביעי האמצעי המוליד טומטום ואנדרוגינוס לא קלט בשום אחת מהם שזהו קללה, לכן דוקא ששה לא פחות ולא יותר:	Exodus 1:7
Paaneach Raza, Shemot 10	(ולחכמים הרמז בו' לשונות שבמקרא, ולמ"ד י"ב מכח פרו שתים וישרצו שתים וכו', ואלו למ"ד ששים לא נתנו רמז במקרא, ואפ"ל כי ט' ווי"ן במקרא זה, ואלו ו' לשונות שבפסוק הרי עשר ווי"ן, ששי"ם, ולמ"ד ששים רבוא אומר זה לרבואות הי', כי כל הענין לומר הפלגות הרבה בעצם):	NULL
Paaneach Raza, Shemot 11	ויאמר אל עמו, וקשה מי יאמר לו מה תעשה אם יגזור מה שיכשר בעיניו ואפי' הריגה הלא מלך הי' ועוד מהיכי תיתי שלא יתרצו לו עד שהוצרך ליטול רשות מהם, וי"ל כי הי' לעלות על הדעת שימאנו בדבר בעבור כי בני אפרים ומנשה היו קרובים להם משרי המדינה והסגנים מצד פוטיפרע לכן הריגה עכ"פ לא יתכן לו לגזור, והסביר להם פנים לתקן באופן שישארו שם ע"כ, דאם לא נבא ונתחכמה נפסיד אותם בלא"ה מטעם ועלה וגו', מרבי:	NULL
Paaneach Raza, Shemot 12	הנה עם ב"י וגו', ע' של עם הוא עקומה, להורות כי ע' נפש ירדו ועצמו ממנו:	Exodus 1:9
Paaneach Raza, Shemot 13	נתחכמה לו, פירשו ז"ל למושיען שנשבע שלא יביא מבול, ותימה הלא מבול פרטי מביא, שהרי בדור הפלגה שפך עליהם מי אוקיינוס והציף שלישו של עולם כדדרש מהקורא למי הים וישפכם, הר"ר יעקב:	Exodus 1:10
Paaneach Raza, Shemot 14	(וי"ל דסברו ודאי גם כזה לא יביא עוד דשבועה שנשבע שלא יביא רק פ"א כדכתיב ולא יכרת עוד כל בשר ממי המבול וגו', קאי נמי אמבול פרטי שיוכל להביאו פ"א ולא יותר כמשמעת ולא יהי' עוד וגו' דע"כ מה שלא הי' באמת מעשה הפלגה העברה על שבועתו הוא מטעם דרשה ולא יכרת עוד וגו' כלומר והמבול הידוע דהיינו לכלל העולם כדכתיב כל בשר דמשמע הא פרטי שלא לכל בשר כעין הפלגה יכול להביא וא"כ גם תשובתו בצדו בדרשה ממש אמבול פרטי דכתיב בסיפא דקרא ולא יהי' עוד מבול וגו' דמשמע אף מבול סתמא בלי ה"א הידיעה, כלומר דבמקצת מבול דדייקינן כבר שיוכל להביאו אף הוא לא יהי' עוד, כלומר לא יותר מפ"א, וכעין זה חזינן במבול אש של סדום דדייקינן ממ"ש ולא יהי' עוד המים למבול וגו', דדרשינן הא מבול אש יכול להביא קאי נמי עלי' שבועה דלא יהי' עוד מבול שלא יביאנו רק פ"א שלכן כל ימי הארץ עד כה לא נשמע כזאת, והיינו מפני דכתיב שנית בפסוק הזה סתם ולא יהי' עוד מבול, כלומר אף שאינה של מים דהיינו של אש הרמוז ראשונה במאמר ולא יכרת וגו' ממי המבול דמרבינן לי' מקרא כנזכר דיוכל להביאו כללו מ"מ בזכרון הסתם השני הנזכר לומר ולא יהי' עוד מבול שלא זכר בו לשון מים לומר שגם אותו יביא לכל היותר פ"א) וכן סברו וחשבו במבול מים של מקצת כנז' וסברתם אמתית שלא הביאו רק הם באו לתוך הים ולא הים עליהם:	NULL
Paaneach Raza, Shemot 15	ועלה מן הארץ לארץ מולדתו שהוא גבוה מכל הארצות וזהו ועלה:	NULL
Paaneach Raza, Shemot 16	שם האחת שפרה, בשם רי"ח מצאתי שמצריות היו מתחלה ונתגיירו, דאל"כ איך בטח בהם לב פרעה לצוותם להרוג הילדים, או הם היאך שתקו בדבר כאלו ניאותו לדבריו הלא בכזה יהרג ואל יעבור, וגם מה רבותייהו דקאמר ותיראן המילדות וגו' אלא שמצריות היו ועתה בהוה ותיראן וגו' שנתגיירו, אבל כבר לא הי' בהם יראת אלהים:	Exodus 1:15
Paaneach Raza, Shemot 17	מילדת חסר כתיב בגימט' יכב"ד ב"ת לו"י:	NULL
Paaneach Raza, Shemot 18	ויעש להם בתים ויהי כי יראו וגו', כלומר בשביל שיראו את אלהים התחכם פרעה ויעש הוא להם למצריות בתים כלומר להושיבם בין בתי ב"י שירגישו ע"י ילדיהן בילדי ישראל כענין אחזו לנו שועלים, וזה ופסחתי עליכם ופסח ה' וגו', שהוצרך לדלג על בתי ב"י דכתיב אשר פסח על בתי ב"י, כי בתי מצריים ועבריים היו מעורבבים יחד, מהר"ר משה:	Exodus 1:21-22
Paaneach Raza, Shemot 19	ד"א ויעש להם בתים, פי' הר"ר אהרן זקנו של הג"ן שכשאמרו לפרעה כי חיות הנה נחשבו לשקרניות לפרעה דאיך ישתנו נשי העולם בטבעיהן זו מזו, וע"ז אמר וייטב אלהים למילדות שהטיב להן להמליטן מידו, ובמה, זהו וירב העם וגו' שנתאמת הדבר אצל פרעה עי"כ, ואמר אם לא כן איך יספיקו שתי מילדות לעם רב כזה ולריבוי הנולדים, וזהו ויעש להם השי"ת למילדות בתים, שישבו לבטח בבתיהם ולא הוצרכו עוד לפחד מחמת מלך מלאכי מות:	Exodus 1:21-22
Paaneach Raza, Shemot 20	ויקח את בת לוי, פירש"י שחזרה לנערותי', וזה מדשני קרא לומר את בת לוי ולא אמר את יוכבד כמו ויקח את אלישבע וגו' וכיו"ב אלא כתיב בת לדרשא שנעשית כבת מתחלה, הר"ר יצחק ממור"ט:	NULL
Paaneach Raza, Shemot 21	כי טוב הוא, פירשב"ם הי' נגמר בשערו ובצפרניו וכל יצירתו ואינו נפל אע"פ שנולד לחמשה חדשים שלמים ויום אחרון של חודש שלפניהם ויום ראשון של שביעי לכן ותצפנו:	NULL
Paaneach Raza, Shemot 22	אות"ו כ"י טו"ב הו"א, בגימט' שנול"ד מהו"ל, לוי:	Exodus 2:2
Paaneach Raza, Shemot 23	ולכך אומרים הודו לה' כי טוב בשעת מילה:	NULL
Paaneach Raza, Shemot 24	ותשלח את אמתה, אמרו בסוטה שנשתרבב זרועה ס' אמה וזכר לדבר שאמרה מן המים משיתהו, והיתה יכולה לומר ממים משיתו, הרי נ' ה' ה' יתרים עולים ששים:	NULL
Paaneach Raza, Shemot 25	נע"ר בכ"ה, בגימט' וד"א אהר"ן הכה"ן שאהרן הי' בוכה על הילד היולד מאימת פן יקראנו אסון המים ומתוך כך חמלה עליו ואמרה מילדי העברים זה ולא אסופי או שתוקי שדרכן ג"כ להיות מושלכים בסוף וקנה, כן פי' ר"י חסיד:	Exodus 2:6
Paaneach Raza, Shemot 26	וימת מלך מצרים ויאנחו, הרי הי"ל לשמור במיתת איש צר ואויב הרע הזה, אלא שבמנהגו של עולם כשיקום מלך חדש כל אסורי המלך הראשון יוצאים חפשי חנם, והם בראותם כי לא ניתנו לרווחא, ויאנחו באמרם אין סוף לצרתם, מהר"ר משה:	Exodus 2:23
Paaneach Raza, Shemot 27	אחר המדבר, מקום מרעה לצאן:	Exodus 3:1
Paaneach Raza, Shemot 28	מתוך הסנה, שהוא מקום טהרה מצד שאין אדם ובהמה הולכים במקום קוצים, פי' רי"ח:	Exodus 3:2
Paaneach Raza, Shemot 29	מעל רגליך, מפני כי גם בתי יד נקראים נעלים כדכתיב בבועז שלף איש נעלו ומתרגמינא נרתק יד ימיני' לכן הוצרך לפרש כאן שברגלים ידבר, הג"ן, וקשה למה לא אמר כאן ויעש כן משה כביהושע וי"ל שלא קרב שמה לכן לא הוצרך לחלוץ:	Exodus 3:5
Paaneach Raza, Shemot 30	ויסתר משה פניו, תימא דאמרינן בגמ' שבזכות זה זכה לקלסתר פנים אלמא החזיק לו הקב"ה טובה על כך, ואמרינן בשעה שבקש משה לראות אמר לו הקב"ה כשרציתי לא רצית וכו' הרי כי לא יפה עשה, הר"ר יעקב:	Exodus 3:6
Paaneach Raza, Shemot 31	(וי"ל דבודאי בעצם הבושה והצניעות של ההסתר פנים מדה טובה הוא וראוי במדה כנגדה לקלסתר פנים, אבל לענין שכבש העינים מלראות אחרי שבקש הוא ית' להגלות אליו לא יפה עשה, והי' יכול לכסות ולהצניע הפנים בידו או בלבושו דרך צניעות ובושה בעינים פתוחות כנהוג בבעלי צניעות וק"ל):	NULL
Paaneach Raza, Shemot 32	ואמרו לי" מה" שמו" מה" אומר, ס"ת השם הגדול ואח"כ אמר עליו זה שמי וגו' וסמיך לי' לך ואספת וגו' לומר שאין מגלין שם הנכבד כ"א לזקנים וצנועים:	Exodus 4:2
Paaneach Raza, Shemot 33	אהי"ה בגימט' א"ך וכן ר"ת של ה' אלהינו ה' וכן ר"ת של אברהם יצחק ויעקב, וכן ר"ת של ה' חומשי תורה (ולהורות כי מצד כל שמותיו הן אהי"ה הן בן ד' וכל השאר אשר כל התורה מלאה מהם אין מתיחס אליהם שום ריבוי רק לאחדות אחד גמור כולם הולכים וייחדום האבות הקדושים שהם הם המרכבה באחדות גמור בלתי בעל תכלית כענין אך שענינו המיעוט לכך גם אך עולה כמספרם:	Exodus 4:15
Paaneach Raza, Shemot 34	אהי"ה אש"ר אהי"ה, עולה שם של מ"ב (שהוא מדת הגבורה והפחד שלכן רמז לו בו גם עתה שאר גליות העתידות:	Exodus 4:28
Paaneach Raza, Shemot 35	מזה בידך מ' זה ר"ל זה שבידך שיעור מ' סאה, שכך נתנו ז"ל שיעור במטהו, ד"א מ' זה, שבזה שבידך תוליך ז"ה שבטים מ' שנה:	NULL
Paaneach Raza, Shemot 36	ד"א מזה, ר"ל שזה שבידך הוא ממין הלוחות שבהם נאמר מזה ומזה הם כתובים:	NULL
Paaneach Raza, Shemot 37	"מי "שם "פה "לאדם וגו' ר"ת משפ"ל כלומר זהו כבודי שאפי' מבן אדם השפל ושאין לו פה ולשון יהא נעשה שליחותי בדבר גדול כזה, רבינו בכור שור:	NULL
Paaneach Raza, Shemot 38	פקח או עור, פירש"י מי עשאן עורים כשברחת וכו', וקשה הלא לעיל פירש"י שנעשה צוארו של שיש ולא שלטה בו חרב (וי"ל דודאי לא יכחיש רש"י מ"ש ויברח משה וגו' אלא שהדבר כן הוא דבאמת לפי שעתו נעשה צוארו של שיש כשבקש פרעה להרגו עתה אבל מ"מ אח"כ משם והלאה לא הי' משה בטוח שם שבכל שעה שירצה יהרגנו, ולא בכל יומא מתרחיש ניסא ואין סומכין וכו' ולכן ברח לו אעפ"כ ולאותה בריחה היו יכולין לעכב על ידו או לרדוף אחריו לולא פלאי השי"ת אשר ישים פקח או עור שעשאום עורים לזה:	NULL
Paaneach Raza, Shemot 39	שלח נא ביד תשלח, בס' חפץ פי' שאמר משה תן לי הדברים בכתב שאוכל לשאת בידי ולהראותם אחר שאני כבד פה וכבד לשון, זהו ביד תשלח:	Exodus 6:1
Paaneach Raza, Vaera 1	@שמות פרשת וארא	NULL
Paaneach Raza, Vaera 2	ובעזר האל הגדול הגבור והנורא, נתחיל סדר וארא:	NULL
Paaneach Raza, Vaera 3	וידבר אלהים" אל" משה", ס"ת למ"ה לרמז שמה שדבר אתו משפט, הוא על אודות למה הרעותה, וידבר אלהים, לפניו כתיב מארצו, מלמד שלא נדבר עמו במצרים תוך העיר כדלקמן, לוי:	Exodus 6:2
Paaneach Raza, Vaera 4	וארא, בגימט' יצח"ק, להורות כי בזכות יצחק ועל ידו נגאלו, וכדברי המדרש שניאות לשנות שמו מישחק ליצחק כדי שימעט הקב"ה בגזרת ת' שנה כמספר ההפרש שבין אלו ויעמוד הגלות על רד"ו מה שלא רצו לעשות לא אברהם ולא יעקב לשנות שמותיהם על כך וזהו אברהם לא ידענו וגו', לוי:	Exodus 6:3
Paaneach Raza, Vaera 5	(ואני אומר כי בא כאן רמז יצחק מפני שבהכרח ממדתו יביאו גם הרחמים על גאולה כי הדין והרחמים כלולים ומדתו מדת פחד יצחק הוא שגרם הגלות והשעבוד לזרעו, לכן גם מינה ובה הכרח הגאולה ברמז כי ביצחק יקרא וגו', כלומר שמצד יצחק יהא נקרא דרור ויקרא לזרעך לאמר לאסורים צאו, ובשביל זה עצמו דילג הוא ית' את הקץ לחשוב דוקא מלידת יצחק כי למדתו הוא סבת ההפכיי שעבוד וחירות, כי דין ורחמים בלי פירוד חלילה, וענין זה הוא מתפשט ומתרחב מאד ומיישב ענינים רבים בכל הפרשיות האלו בויכוח השי"ת ומשה וכל דבריהם ועל ככה דיבר אתו משפט בזה המקום כי משה לא שיער מתחלה שיצאו דין ורחמים ממקום א', והוא כל טענתו וסירובו בשליחות זה, וכבר הארכתי בו במקומות אחרים שלא בזה הספר לכן אין להאריך בו ג"כ כאן):	Exodus 6:3
Paaneach Raza, Vaera 6	וארא ו' ארא, כי ו' פעמים מצינו באבות וירא ה' באברהם ג"פ ביצחק ב' פעמים ביעקב פ"א:	Exodus 6:3
Paaneach Raza, Vaera 7	וארא" אל" אברהם", ס"ת אל"ם שעל שעשה עצמו אלם בכל הנסיונות זכה להיות אב המון:	Exodus 6:3
Paaneach Raza, Vaera 8	באל שדי, נגלה לו בזה דוקא מפני כי ס"ת משמות האבות שהם מק"ב הם בא"ת ב"ש אותיות שדי (והטעם כי די לו ית' בהם בעולמו, והוא הטעם שר"ת של שמותיהם עולים אהי"ה כדלעיל לומר כי בהם ובשבילם בלבד די לי שאהי' בעולמי מראש ועד סוף:	Exodus 6:3
Paaneach Raza, Vaera 9	לתת להם את ארץ כנען, רמז לו לשרות שם שכינתו בתוכם בשני מקדשים כמנין לת"ת דהיינו ת"י ת"ך שנים:	Exodus 6:4
Paaneach Raza, Vaera 10	לכן אמור וגו', לכן עולה בגימט' ק' לומר כי כמו שנולד יצחק לאברהם לק' שנה כך לק' שנה ליעקב כבר נולדו לו כל בניו, זהו לכן אמור לב"י (והטעם בכולם להיות הדבקים בה' אלהים חיים כולם ביראת שמים שהי' בכולם, כי ק' זה הקדוש ב"ה וק' הוא ענין היראה ע"ד מה ה' אלקיך שואל וגו' [א"ת מה אלא מאה] והדבר עמוק ונמרץ הרחבתי בו פעמים ואכ"מ להאריך) גם בזה הפסוק נמצאים כל אותיות האלפ"א בית"א חוץ מן הק' באשר נעלמה במספר לכן (והרמז בזה כי ענין והוצאתי וגו' הוא בתנאי ולתכלית שישמרו התורה מאל"ף עד ת' כמצות הנעלם והנסתר ית' הרמוז באות ק' כנז'):	Exodus 6:6
Paaneach Raza, Vaera 11	והוצאתי והצלתי וגו', הרי כנגד ד' לשונות גאולה אלו תקנו ד' כוסות כנודע, והטעם שתקנו הרמז בכוסות דוקא ולא במצות או דברים אחרים, הוא כנגד מה שבירמיה גבי פורעניות של אוה"ע נמצאים ד' כוסות ג' כתיבי ועברו וחד לעתיד לבא:	NULL
Paaneach Raza, Vaera 12	הן בני ישראל לא שמעו וגו', פירש"י זה א' מעשרה קלים וחמורים שבתורה, ואין להקשות מה ק"ו הוא זה דלמא שאני ב"י כדכתיב ולא שמעו אל משה מקוצר רוח ומעבודה קשה, וה"פ שלא שמעו ולא ניאותו לצאת מאימת עבודה קשה שיעמיס עליהם הש"י מכח קוצר רוח שבנו וא"כ שפיר הוי ק"ו לענין יציאה שאז הם אינם רוצים לצאת כ"ש שלא ירצה פרעה לשלחם, מהר"ר משה:	Exodus 6:9
Paaneach Raza, Vaera 13	ד"א לענין פרעה יאמר כן, שהוא לא יתלה מניעת שמיעתם בקוצר רוח וגו' ויאמר בלבו אם הם לא שמעו איך אשמע אני:	Exodus 6:9
Paaneach Raza, Vaera 14	מקצר רוח, חסר ו' לרמז מספר ת"ל שנה שאז דוקא יצאו כדכתיב ומושב ב"י וגו':	Exodus 6:9
Paaneach Raza, Vaera 15	ובני קרח וגו', וקשה למה לא מנה גם בני חברון, וי"ל דלא מנה כל הני אלא משום משה ואהרן והנתלה באיזה מעשה שאירע בהם לכן אמר שבני עמרם משה ואהרן ובני יצהר קרח שחלק עליהם ואגבי' מנה לכל אחיו ובניו, ומישאל ואלצפן וסתרי משום שהיו במעשה דנדב ואביהוא, ונחשון לומר שרוב בנים אחרי אחי האם, ופנחס משום מעשה זמרי, וכל אינך לא הוצרכו לשום מעשה:	NULL
Paaneach Raza, Vaera 16	ויקרא גם פרעה, לרבות אשתו שהיתה שקולה במכשפות נגד כל החכמים והמכשפים:	NULL
Paaneach Raza, Vaera 17	לך אל פרעה בבוקר וגו', פירש"י וכן יש במדרש שהלך לנילוס לעשות צרכיו וכו', וקשה וכי יתכן לומר שמעולם לא ראהו שום אדם, הרי הי' מקום גלוי, ויותר הי"ל מטעם זה לילך למקום צנוע או לעשות לו בית הכסא בחדרו, ועוד אם עשה עצמו אלוה לא הי"ל לילך לנילוס כי כל רואיו יאמרו כי לעובדו ילך שמה שהרי היו משתחוים לנילוס, לוי:	NULL
Paaneach Raza, Vaera 18	(וי"ל דאף אם לעתים רחוקים מצאו אדם יחשוב אותו ביותר לאלוה ולא את הנילוס בשגם הוא נוהג בזיון גדול כזה בנילוס ויתאמת אצל הרואה מאמרו לי יאורי ואני עשיתוני, ועוד פשוט שבשביל כך גזר גזירה ששום אדם לא יצא מפתח ביתו עד שעה ידועה לו לפרעה לאחר שובו מהנילוס באופן שלא ימצאנו שם אדם ולא יראנו הולך שמה), והג"ן מפרש שיצא שמה לצוד עופות כמנהג המלכים ואין רבים מצויים שם ותוכל להתבודד ולדבר עמו שם:	NULL
Paaneach Raza, Vaera 19	נטה את ידך" על" מימי" מצרים", ס"ת כלי"ם כי גם שבכלים נהפך לדם, ופירש"י ז"ל שלקה היאור תחלה מפני שהי' יראתן ואלהותן, וקשה שהי' ראוי בשביל כך להקדים מכת דבר לצפרדעים כי בו לקו גם הצאן שהיו ג"כ יראתן, וי"ל דשאני מכת צפרדעים שנתיחדה באלהות לבד משא"כ בדבר שלא בא ביראתן לבד רק בכל הבהמות:	NULL
Paaneach Raza, Vaera 20	ובאש היאור, ונלאו מצרים וגו', פי' אף שיחזרו המים לקדמותן כי הדגים מתו והבאישו היאור ולא מחמת הדם שהדם חזר לאלתר דלכך לא שת לבו לזאת ולא קראם להחזיר המים דאל"כ מהיכן לקחו החרטומים מים לעשות כן גם הם, מהר"ר משה:	NULL
Paaneach Raza, Vaera 21	התפאר עלי למתי אעתיר וגו' ויאמר למחר, וקשה מה עלה ע"ד פרעה שלא בקש ההסרה מיד כבכל שאר המכות וכן משה מהיכי תיתי אסיק אדעתי' דלאו לאלתר וי"ל דהאי למתי לא קאי כלל על ההסרה וממילא תשובות למחר נמי לאו אהסרה קאמר כי באמת התפלה וההסרה תיכף היו כמשמעות הפשוט במאמר העתירו את ה' ויסר וגו', דהעתרה עכ"פ תיכף היתה אלא לענין סוף דברי פרעה דקאמר ואשלחה את העם וגו' אמר משה התפאר עלי למתי יהי' זה שתקיים דבריך אלה ואעתיר אני לך ולעבדיך עתה להכרית וגו', והטעם מסייע כי בא טעם פסיק בלמתי להפסיק מאעתיר לך, מהר"ר משה:	NULL
Paaneach Raza, Vaera 22	(ולי נראה דודאי מתי אהסרה קאי שבתחבולה וחריפות א"ל משה התפאר עלי וגו' שפי' לכבודך לא תסור המכה תיכף כאשר בקשת, רק לאימת שתרצה לאח"ז כדי שתוכל להתפאר על ידי נגד עמך כמתנבא ויודע עתידות מתי יסורו שזהו לשון התפאר דנקט דוקא. ואמרו עלי פי' על ידי, והתרגום מסייעני, וטעמו של משה הי' כי רביעית החודש שמשה כל מכה וידע משה שיכלו למחר ובטח לבו בפרעה שמכח עלי לא ישאל עוד הסרתו תיכף ושבודאי ישאל על זמן היותר קרוב האפשר דהיינו למחר, לכן אמר לענין אימת ההסרה התפאר עלי, על ידי וקבע לך זמן לזה ואעתיר אני תיכף וזהו ג"כ הוראת טעם הפסיק להפריד ההעתרה וההסרה בזמן, והנה פקפוקים מענין זה מתיישבים בכך):	Exodus 6:16
Paaneach Raza, Vaera 23	ויעש ה' כדבר משה וימותו וגו', וקשה הלא זה לא הי' כדבר משה, כי משה אמר וסרו הצפרדעים ולא שימותו, וי"ל דאותן שבגופי ב"א ושבבית המלך סרו, ושל בתי שאר העם מתו, מצאתי:	Exodus 8:9
Paaneach Raza, Vaera 24	(אכן לא נרגש דבר זה בפסוקים, ואני פירשתי שתמצא מבואר נגלה כי פרעה לא ביקש כריתה לגמרי דהיינו שימותו רק וסרו וגו', ולא אמר רק ממני ומעמי דהיינו מהגוף, אבל מבתים וחצרות לא ביקש, ומשה כדי להראות פלאי ורחמי השי"ת הוסיף מדילי' והתפלל על הכריתה לגמרי גם מהבתים, שלזה ג"כ נתן הדבר לקביעות זמן פרעה כדכתיב למען תדע וגו', ולכן הוסיף עוד לומר וסרו וגו' אחר שאמר להכרית וגו', כלומר עוד לטוב לך לא תהי' הכריתה מתחלה תוך מעיכם ובתיכם וחצריכם שזה הי' גורם לכם חולי ובאושה אלא ביותר הפלא יהי' דהיינו וסרו וגו' קודם הכריתה ואח"כ ימותו בריחוק מקום, וזהו על נכון ויעש ה' כדבר משה ממש ולא כדבר פרעה, שעשה ממש כזאת, שזהו דכתיב וימותו הצפרדעים מן הבתים ומן וגו' דאל"כ בבתים ובחצרים מבע"ל, אלא שסרו תחלה ואח"כ מהם וחוצה מתו, ונכלל בזה ממילא גם שבתוך מעיהם, שהרי הוצרכו למות בריחוק מהבתים וא"כ פשיטא שסרו גם הם תחלה, וזהו ותבאש הארץ ולא הבתים והחצרות והשדות, ולכן כתיב כאן ויצעק יותר מבכל מקום, כי הוצרך לצעוק ביותר כיון שהוא ביקש יותר מפרעה):	Exodus 8:9
Paaneach Raza, Vaera 25	וימותו מן הבתים ומן וגו', אבל מן התנורים לא מתו רק סרו מפני שמסרו עצמן על קידוש ה' כדאמרינן שנשאו חנניא מישאל ועזריא ק"ו מהם, ומה שבצפרדעים מתו ובערוב לא מתו כדכתיב ויסר הערוב, משום דהתם לא נבראו לכך רק של כבר באו ונקבצו כדכתיב הנני משליח בך וגו' ולא הוצרך רק להחזירם למקומם. אבל הצפרדעים נבראו לזה יותר כדכתיב ושרץ היאור צפרדעים, לא רצה להחזירם ליאור, אורליינ"ש:	Exodus 8:9
Paaneach Raza, Vaera 26	והך את עפר וגו', מה שהשלישית היתה תמיד בלי התראה, מפני שאמרו מי שלקה ושנה מכניסין אותו לכיפה וכו', ומה שחזר להתרות אח"כ באחרות מפני שכ"א מסימני דצ"ך עד"ש באח"ב היו באין ממיוחד להם, אלו מהש"י ואלו ממשה וכו', וכל סימן הוא ענין וגדר אחר, גם בסגנון אחר וממקום אחר, אלו מהארץ, ואלו מעל הארץ וכיוצא:	Exodus 8:12
Paaneach Raza, Vaera 27	והפליתי ביום ההוא, בשאר המכות לא כתיב כן משום שאינם ראוים לבא מעיר לעיר ממדינה למדינה כגון כנים וצפרדעים אף שהם בעלי חיים, לכן לא הוצרך הפלאה, לאפוקי ערוב שדרכם לבא לכן הי' צריך הפלאה, וכן בדבר, מהר"ר שמשון:	Exodus 8:18
Paaneach Raza, Vaera 28	וימת כל מקנה מצרים, כלומר כל שמתו היו של מצרים, וממקנה בנ"י לא מת א', אבל לא שמתו כל מקניהם של מצרים שהרי כתיב לקמן הירא את דבר ה' הניס וגו', ותימה למה לא כתיב בדבר הירא את דבר ה' וגו' כבברד, שהרי לא היתה הגזירה רק על המקנה שבשדה, וי"ל דלא צריך דמכיון שהאמינו בגזרה חדשה חמורה ותמוה כברד, כ"ש שהאמינו בקלה ונהוגה, בדבר, ופשיטא שהניסו, אורליינ"ש:	Exodus 9:6
Paaneach Raza, Vaera 29	שלח העז וגו', וא"ת למה לא אמר כן בדבר, וי"ל דא"כ לא הי' מקום להביא המכה כלל מכיון שיאספו המקנה הביתה, אבל בברד נשארה המכה על אילנות וזרעים, הר"ר שמואל:	Exodus 9:19
Paaneach Raza, Vaera 30	ועי"ל שלא היתה גזרת הדבר אלא על המקנה לא על בני אדם, ואולי בהביאם המקנה הביתה ידבק הדבר בב"א ויהי' זה טובה דאתיא לידי רעה גדולה ממנה יותר מה שאין שייך כן בברד:	NULL
Paaneach Raza, Vaera 31	את כל מגפותי, פירש"י למדנו מכאן שמכת בכורות שקולה וכו' אמר מהר"ר אברהם שראה בפירש"י בכת"י שכתב מכה מיתת הבכורות, ולא כפי' מהר"ר משה שרוצה לפרש ענין ביכור כמו בכיר ולקיש (ע' בגור אריה):	NULL
Paaneach Raza, Vaera 32	חטאתי הפעם, פי' הפעם הזה מכיר אני שחטאתי באמרי לא ידעתי את ה' כי עכשיו רואה אני כי ה' הוא הצדיק שהזהירני לומר שלח העז להנצל, ולא כן מדת בשר ודם נגד מתנגדו, מהר"ר משה:	NULL
Paaneach Raza, Vaera 33	ד"א זה הפעם ממש חטאתי, דאלו בשאר מכות לא נזהרתי מפניו שלא ידעתי להזהר, אבל עתה שלימדני איך להזהר חטאתי במה שלא נזהרתי, מהר"ר יעקב:	NULL
Paaneach Raza, Vaera 34	(ועי"ל כפשוטו, זה הפעם בפרטות חטאתי במה שלא שמעתי לשלחם דכיון שראיתי חסדו וטובו שלמדני להועיל איך להנצל הי' לי להתחרט ולהכנע לאהבה אותו ולעבדו לרוב גדלו), ד"א כיון שאמר הנני שולח את כל מגפותי ולא סרתי למשמעתו ולא חשתי לדבריו בזה חטאתי, מהר"ר אליעזר:	NULL
Paaneach Raza, Vaera 35	כצאתי את העיר, פי' אף שבשדה יש קולות וברד אלך שמה ולא אתנזק, מהר"ר משה:	Exodus 9:25
Paaneach Raza, Vaera 36	כי אפילות הנה, פירש"י פלאי פלאות נעשה להם שלא לקו וקשה מהו הפלא בזה שהרי בטבע לא לקו דהא כתיב והשעורה אביב משמע שאלמלא כן גם הם לא לקו וכן הזרעים ועשבים לא נתקלקלו, וי"ל שהפלא הי' שאף שלא לקו מצד רבותן מ"מ הי"ל להיות נשרפים כדאיתא במי שמתו שתבואה רכה לוקה בשדפון אפילו"ת אותיות פלאו"ת:	NULL
Paaneach Raza, Vaera 37	הקולות יחדלון וגו', ולא אמר גם בהם שלא יהיו עוד, מפני שלא יחדלו רק עד מתן תורה ושם יהיו עוד אבל הברד כלל לא יהי' עוד:	Exodus 9:29
Paaneach Raza, Vaera 38	כי השעורה אביב, וקשה הלא מכת בכורות בניסן היתה וכל מכה ומכה נמשך ענינה בין הכל חודש ימים חשוב לאחורך ותמצא כי מכת הברד היתה בטבת ואיך הי' אז אביב, אף בא"י שהיא קלה לבכר פירותי' מכל הארצות בטורח גדול מצאו שעורים בט"ו בניסן למנחת העומר, וי"ל דלזרעים ארץ מצרים בכרה קלה מא"י, וא"י לפירות האילן יותר כדכתיב כגן ה' כלומר באילנות כארץ מצרים לזרעים:	NULL
Paaneach Raza, Vaera 39	סליקא לה פרשת וארא, ברוך שהדורות מראש קרא:	Exodus 9:30-31
Paaneach Raza, Bo 1	@שמות פרשת בא	NULL
Paaneach Raza, Bo 2	ובעזר ישמשוני' אלף אלפין ורבוא, נתחיל סדר בא:	NULL
Paaneach Raza, Bo 3	בא אל פרעה, כאן אמר בא ולא לך, מפני שמשה הי' סבור מכיון שהתודה בברד לומר חטאתי הפעם בודאי מעתה ישלחם ויצוה לישראל להזמין עצמם לדרך, לכן א"ל השי"ת בא וגו' כלומר אדרבה דכבר אמרתי, לך, כלומר שתלך לבדך אבל עתה לבן יותר כבד עד שצריך אני לבא עמך כי אני הכבדתי וגו', זהו בא, כלומר ונבא אני ואתה בא בגימט' ג' לומר ג' מכות אביא עליו עוד וכנגד הקב"ה משה ואהרן כדכתיב אח"כ ויבא משה ואהרן וגו':	Exodus 10:1
Paaneach Raza, Bo 7	ד"א כשהי' פרעה בבית אמר הקב"ה למשה בא כלומר ואלך עמך, וכשהי' על המים אמר לו לך כלומר לבדך שאין כבוד השכינה לילך שמה (בא הוא נוטריקון ברד ארבה ולמפרע עוד הוא נוטריקון "אופל "בכורות שרמז לו בזה אותן ג' מכות של אח"כ שמעותדין עוד לבא הם שייכים עם מכת ברד שעברה בקרוב והקשר אחד להם יחד לא יתפרדו, לכן לא כדעת משה שסבור שעתה יתחרט וישלח ישראל והרי לזה ניתן לארבעתם ג"כ יחד סימן מיוחד שהוא באח"ב מפני שסוג א' מיוחד להם ויחד נקשרים ושייכים בכל פנים ואופנים כנודע וזהו בא אל פרעה וגו' למען שיתי אותותי אלה בקרבו אמר אותותי אלה לשון רבים ועם כ"ז אמר לשון אלה כרומז אליהם באצבע והרי אין מפורשת לפניו וגלוי' אלא ארבה לבד אלא ששלשתן העתידים רמוזין לפניו במלת בא כנז'):	Exodus 10:1
Paaneach Raza, Bo 5	ואת לב עבדיו, זכרם כאן כיון שכבר כתיב ויכבד לבו הוא ועבדיו, מהר"ר משה:	NULL
Paaneach Raza, Bo 6	כי אני הכבדתי, זהו במקום ויחזק ה' וגו', שמשמע ברש"י לעיל בפ' וארא שבחמש אחרונות כתיב ויחזק ה' והרי ברד הוא מהם וכתיב בה ויחזק לב פרעה, כלומר מעצמו ולא ויחזק ה', אלא כי אני הכבדתי הוא כמוהו, (והענין מ"ש בו גם ויחזק לב פרעה, מפני שאף שהי' הברד בפלאי פלאות והי' ראוי שיכנע ע"י כך עד שהוצרך הוא ית' לחזק לבו שלא יציית עדיין, מ"ט להיותו ענין הנהגיי בעצמו שיורד ברד שנה שנה הוסיף מן דילי' גם לחזק לבו בעצמו אחרי שהחזיקו הש"י, והוא רמז הכתוב שם ויוסף לחטוא ויכבד וגו', וייתור ויחזק לב פרעה הכתוב תיכף אחריו הוא לומר שמה שהחזיקו כאן בעצמו הוא ייתור ותוספת):	NULL
Paaneach Raza, Bo 7	ולמען תספר באזני בנך ובן בנך כי עד כאן חייב אדם ללמוד לזרעו תורה, ועד כאן יגיעו רחמי אב על הבן שנא' אם תשקור לי:	Exodus 10:2
Paaneach Raza, Bo 8	הנני מביא וגו', וקשה היכן רמז לו הקב"ה מכת הארבה, וי"ל דמכיון שאמר אותותי אלה ע"כ רמז לו עליהם והראם לו, מהר"ר משה:	Exodus 10:4
Paaneach Raza, Bo 9	ועי"ל דודאי א"ל הקב"ה בפירוש אלא שאין להאריך ולכפול לכן יכתוב לפעמים האזהרה באמירת הקב"ה למשה ולא במעשה ולפעמים איפכא, והנה כאן כתבה בשליחות לצורך דברי פרעה אל משה ויושב וגו' ולדברי העבדים לפרעה עד מתי וכו', והיכא דיש נפקותא באמירתו ית' כמו בצפרדעים ועלו ובאו בביתך ובחדר משכבך וגו' ובתנורך וגו' כתבה לבדה, רבינו בכור שור:	NULL
Paaneach Raza, Bo 10	ואחריו לא יהי' כן, פירש"י דהאי דיואל הי' כבד משל משה ע"י מינין הרבה אבל של משה וכו', ותימה הלא גם בזה הי' מינין הרבה, כדמונה להו בתהלים חנמל ארבה חסיל, ותירץ ר' חיים דהני דיואל היו באים זא"ז כדכתיב יתר הגזם אכל וגו' אבל אלו שבכאן היו ביחד ומצד זה אינו קשה כ"כ ומ"מ לא מתיישב מ"ש רש"י אבל של משה לא הי' אלא של מין א', לוי:	Exodus 10:14-15
Paaneach Raza, Bo 11	וי"מ ואחריו לא יהי' כן במצרים דוקא קאמר ודיואל בא"י הי' ושם לא הי' כמוהו, גן:	NULL
Paaneach Raza, Bo 12	ורוח הקדים נשא וגו', פי' כי הוא חם מאד והארבה משריץ מהחום וכשהקב"ה רצה להסירו כתיב ויהפך ה' רוח ים שהוא הקור וההפך, מצאתי:	NULL
Paaneach Raza, Bo 13	עד מתי יהי' זה לנו למוקש זה היינו משה ככתוב כי זה משה האיש:	NULL
Paaneach Raza, Bo 14	ויתקעהו ימה סוף, דוקא שמה מפני שכשבא פרעה לתוך הים אז חזר גם הארבה עליו שם וכן כל המכות שלקו במצרים חזרו עליהם בים:	Exodus 10:19
Paaneach Raza, Bo 15	לא נשאר ארבה א', דכל מה שנברא בשביל המכה כמו צפרדעים וארבע כלו ומתו שם לבסוף כולם אבל ערוב שנקבצו מהברואים כבר כאשר באו כן ילכו ולא מתו, ג"ן:	Exodus 10:19
Paaneach Raza, Bo 16	ויהי חושך אפלה וגו', פירש"י שהביא חשך מפני שאם ישאלו איש מאת רעהו לא יוכלו לומר אין בידינו דישראל יאמר הלא ראיתים במקום פלוני וקשה מה הי' צריך לזה הלא נתן את חן העם בעיני מצרים וישאילום, וי"ל דעם כ"ז לא היו יודעים מה לתבוע בשאלה כי מי יאמר להם מה מהחפצים יש להם למצרים אם לא שחפשום וראום בזמן האופל:	Exodus 10:21
Paaneach Raza, Bo 17	וירדו כל עבדיך, בפרק טבול יום וברש"י שחלק כבוד למלכות, וקשה הא כתיב ויצא מעם פרעה בחרי אף דאמר התם מלמד שסטרו ויצא וא"כ לא הי' אימת מלכות עליו, ורי"ח וכן רבינו יצחק פי' לא שסטרו ממש אלא שהרים ידו והראה לו שראוי לסטירה או שא"ל כן בפירוש, וקשה הרי אמרו שם עלה כל היכא דכתיב חרי אף נעשה רושם, ואם לא סטרו רושם היכן הוא, והר"ר אלי' פי' דפרעה סטרו למשה קאמר, ושמא י"ל דמשה חלק כבוד במאמר וירדו כל עבדיך כדי לכתבו למגמר מיני' הך מלתא דמינה ילפינן בטבול יום שאל תהא אימת מלכי אומות קלה בעיניך אבל משה בעצמו לא נתחייב לחלוק כבוד זולת זה כדכתיב ונצבת לקראתו ודרשינן העז פניך נגדו:	NULL
Paaneach Raza, Bo 18	כן דברת, פי' שלא אוסיף לבא אליך ראות פניך אבל אתה תבא אלי כדכתיב וירדו כל עבדיך אלה אלי:	Exodus 10:29
Paaneach Raza, Bo 19	מהר"ר משה:	Exodus 10:29
Paaneach Raza, Bo 20	לא אוסיף עוד וגו', וקשה מנא ידע משה הרי עדיין לא נאמר לו עוד נגע א' וגו', וי"ל דאין מוקדם ומאוחר בתורה ובאמת עוד נגע א' נאמר לו קודם זה וכתיב בי' נגע אחד אביא, אני ולא השליח:	Exodus 10:29
Paaneach Raza, Bo 21	כה אמר ה' כחצות, פירש"י בעמדו לפני פרעה נאמרה לו פרשה זו וקשה הרי פירש"י על כצאתי את העיר שלא נדבר עמו במצרים המלאה גילולים, וי"ל דמ"מ נזרק בו רוה"ק, מהר"ר יעקב:	NULL
Paaneach Raza, Bo 22	ועי"ל שכשאמר פרעה ה' הצדיק וגו' ביער כל הגילולים מן העיר לכן נדבר עמו אח"כ בעיר, ר' טרוישטליין, ועי"ל דהתראה נאמרה אף בעיר אבל תפלה חוץ לעיר, וכן מצוה דוקא חוץ לעיר כפירש"י לקמן אצל מצות החדש:	NULL
Paaneach Raza, Bo 23	גם האיש משה גדול מאד לומר שאע"פ שדיבר הוא אליהן את המכות תמיד לא נעשה לו מאומה כי הוא גדול בעיניהם:	NULL
Paaneach Raza, Bo 24	ומת כל בכור, פי' אף בכור שממקום אחר והוא במצרים ולמה כדי שלא יאמרו יראתם תבע עלבונם, אורליינ"ש:	NULL
Paaneach Raza, Bo 25	אשר אחר הרחיים, ולקמן כתב אשר בבית הבור, וי"ל משום שהי' נהוג אצלם לשעבד בכל מלאכה ובריחיים בהאסורים ביום, ובלילה הם שבים לבית הסהר, לכן על שמתו מהם ביום אמר אחר הרחים ועל שמתו מהם בלילה אמר אשר בבית הסהר, מרבי:	NULL
Paaneach Raza, Bo 26	ולכך הכא דנקט אחר הרחיים קראן בכור השפחה לענין השיעבוד ועבדות, ולקמן שאמר אשר בבית הבור קראן בכור השבי:	NULL
Paaneach Raza, Bo 27	דבר נא באזני וגו', המתין אחר מכה תשיעית שאם היו שואלין מהם קודם לכן היו מוכרחים להחזיר להם כיון שלא הלכו מיד:	Exodus 11:2
Paaneach Raza, Bo 28	ולכל בני ישראל לא יחרץ, פי' אע"פ שהי' בחצי הלילה שהוא באשמורה שניה אשר בה כלבים צועקים, ומהר"ר חיים בשם רבינו שמואל אמר שר"ל אע"פ שכשמלאך המות בעיר כלבים צועקים, וי"מ שהרבותא הוא שאע"פ שהעיר היתה אז מלאה נבלות ולכך זכו לעצמות של בשר שכל הטעם בהם כדאמרינן משחרב בהמ"ק ניטל טעם בשר וניתן בעצמות:	Exodus 11:7
Paaneach Raza, Bo 29	החדש הזה לכם, חד"ש בגימט' לרגלים, לכ"ם אותיות מל"ך מכאן אמרו ניסן ר"ה למלכים ולרגלים חד"ש אותיות נעלמות שלו הם תלתין, כזה ח"ת דל"ת שי"ן לומר שהחדש הוא שלשים יום:	Exodus 12:2
Paaneach Raza, Bo 30	מן הכבשים ומן העזים, בפרט מאלו שהם יראתן והמצריים בשביל שהיו בקיאין בחכמת המזלות וידעו שטלה הוא ראשון למזלות לכן עבדוהו, מרבי:	NULL
Paaneach Raza, Bo 31	והי' לכם למשמרת, פירש"י שטעון ביקור ארבעה ימים, וקשה דאמרינן פ"ק דע"ז אנן דפסלינן בדוקין שבעין בעינן תלתין יומין, ולמה הספיק כאן ד' ימים, וי"ל דהתם לבחון בין מום עובר למום קבוע בעינן כולי האי, אבל לידע אם יש בו מום כל עיקר די בד' ימים, אורליינ"ש:	Exodus 12:6
Paaneach Raza, Bo 32	כי אם צלי אש, באיזהו מקומן אמרינן הפסח אינו נאכל אלא בלילה וכו' ואלו ואינו נאכל אלא על השובע לא קתני, וי"ל דזה אינו מעכב ולא קתני הנך אלא לעכובא, אבל תימה אמאי לא קתני ואינו נאכל אלא בחבורתו, מרבי:	NULL
Paaneach Raza, Bo 33	אך אשר יאכל לכל נפש, דרשינן יכול אפי' עכו"ם ת"ל אך ותימה הא דרשינן בכ"מ לכם ולא לעכו"ם וא"כ הכא תרתי ל"ל, וי"ל צריכי דאי כתיב חדא הו"א ולא לעכו"ם לבדם אבל לעכו"ם בהדי ישראל שרי צריכא, מהר"ר יעקב:	Exodus 12:16
Paaneach Raza, Bo 34	לכל נפש, פירש"י לרבות בהמה, וקשה הא כתיב לכם ודרשינן לכם ולא לכלבים וי"ל דכלבים אין מזונותן עליו שיכולין לחזור בכ"מ אחר מזונותיהם, מהר"ר יעקב:	NULL
Paaneach Raza, Bo 35	עד יום האחד ועשרים, וקשה למה לי מדכתיב שבעת ימים מצות תאכלו, וכתיב ביום הראשון בארבעה עשר לחודש תאכלו וגו' פשיטא דעד כ"א בחודש בערב הוא, וי"ל דסד"א שאלו ז' ימים א"צ להיות צרופים רק שיתחילו בי"ד בערב קמ"ל (ועי"ל דהא דכתיב בי"ד לחודש תאכלו מצות בערב הי' אפשר למטעי בזה ולפרשו בערב שמחרתו י"ד יתחילו לאכול מצות וא"כ יכלו ז' ימים דקאמר בסוף יום עשרים לכן כתב עוד עד יום האחד ועשרים בערב שבזה א"א לפרשו כן לומר עד בערב שמחרתו יום כ"א דהיינו הך, דא"כ לשתוק מבערב דהכא ולימא עד יום האחד ועשרים ותו לא ונדע שפיר דעד התחלתו קאמר דהוא בערב שלפניו, דאין לומר שאז הי' מקום לטעות ולומר שליל כ"א ג"כ זמן אכילת מצה הוא עד אור יום כ"א מדכתיב עד יום כ"א, דאל"כ לא לכתוב מלת יום רק האחד ועשרים ויובן פשיטא רק עד תחלתו. דבשלמא בערב די"ד שפיר הוה אפשר למטעי בי' ולא הוה קשה א"כ לשתוק מיני' דעכ"פ מבע"ל למכתבי' לעשות לילה ראשונה חובה לכזית מצה וא"כ שפיר הוה מצי למטעי ולפרשו בליל י"ד עצמה להכי אצטריך כולה מלתא):	Exodus 12:18
Paaneach Raza, Bo 36	ולא יתן המשחית לבא, וקשה דמשמע שהיתה מכת בכורות ע"י שליח והרי כתיב ועברתי והכיתי וגו' ודרשו ז"ל לא ע"י מלאך וכו', ועוד קשה דכתיב וה' הכה וגו' ופירש"י הוא ובית דינו, הרי שע"י מלאך גם כן היתה, וי"ל דבכורים עצמן לא הוכו ע"י שום ברי' כדכתיב והכיתי כל בכור אבל גדול שבבית במקום שאין בכור נמסר למלאכים ושלוחים, (ועי"ל דהא דכתיב וה' הכה כבר גילה הרמב"ן ז"ל דבית דיני' הוא שכינתי', ומ"מ ולא יתן המשחית וגו' ה"ק אף המשחית לא יתן לבא אל בתיהם, ובודאי המכה במצרים היתה ע"י עצמו וכבודו ית', רק שלישראל הבטיח לא זו דופסח ה' על הפתח אלא אף זו ולא יתן וגו', שאף במנהגו של עולם בזולת המכה שנעשה ע"י שלוחים לא יתן לבא אל בתיכם וגו', ועי"ל דולא יתן המשחית קאי אמלאכי חבלה שהיו עמו כלגיונותיו של מלך והיו חובטים ומכים בלא מיתה גם על זאת פקח עיניו ית' להבטיח לישראל ולהצילם גם מזה, והוא שאמר לנגוף שהוא דחיפת הגוף דחיפה בעלמא, מהר"ר משה:	Exodus 12:23
Paaneach Raza, Bo 37	והי' כי תבאו וגו', שלא נתחייבו עד לארץ, וקשה מ"ש רש"י ז"ל בפ' בהעלותך בפסח שעשו בשנה השני' כדכתיב שם שהי' גנותן של ישראל שלא עשו במדבר כל מ' שנה רק פסח זה, ומה גנות יש בזה הרי לא נתחייבו, וי"ל שהגנות הוא שגרמו לעצמם להתעכב במדבר ולהמשיך החיוב אבל קשה איך נאמר ביהושע ויאכלו מעבור הארץ ממחרת הפסח דמשמע שעשו פסח הלא לא נתחייבו לעשותו עד לאחר ירושה וישיבה, דבכ"מ דכתיב והי' כי תבאו לאחר ירושה וישיבה הוא, וי"ל דלענין חובת קרקע דוקא דרשינן לי' לאחר ירושה וישיבה כגוף הלשון דכי תבאו אל הארץ אבל לענין חובת הגוף לא, מהר"ר יעקב:	NULL
Paaneach Raza, Bo 38	ויקרא למשה ולאהרן לילה, לא דקאי עלי' מ"ש אח"כ ותחזק מצרים על העם למהר וגו', ולומר דבלילה יצאו דהא כתיב אל יצא איש מפתח ביתו עד בוקר, אלא שהם בקשו שיצאו, שזהו ותחזק וגו' למהר לשלחם וגו', אבל באמת לא יצאו עד בוקר, ומ"מ מקיים שפיר כי גורשו ממצרים שהפצירו בם ודחקום עד יציאתם:	Exodus 12:31
Paaneach Raza, Bo 39	וישאילום וינצלו וגו' ואין כאן חילול ה' במה ששקרו בם כי אמרו להם ואנחנו לא נדע מה נעשה רק אנו הולכים למדבר אם משה מחזירנו מוטב ואם לאו הרי כל שדותינו ונחלתינו אפותיקא לכם, רי"ח:	Exodus 12:33
Paaneach Raza, Bo 40	ויסעו ב"י מרעמסס וגו' אחז"ל שנסעו אותו יום ס' מיל, וזהו רמז ר"ת וס"ת של "ישראל" "מרעמסס", שהם אותיות "ס' מי"ל, רי"ח:	Exodus 12:37
Paaneach Raza, Bo 41	כי לא חמץ כי גורשו וגו', האי כי גורשו לא נתינת טעם לכי לא חמץ הוא, שהרי אף אם לא גורשו לא היו אוכלים חמץ, שהרי נצטוו על כך, אלא דוקא לנתינת טעם אויאפו את הבצק שהי' אחר היציאה ושלא אפאוהו שם במצרים, לזה אמר הטעם כי גורשו, ג"ן, אורליינ"ש:	Exodus 12:39
Paaneach Raza, Bo 42	(ואני אומר דשפיר קאי אכי לא חמץ ולומר איך אפשר שלא הי' חמץ מכיון שהוציאוהו ממצרים ואח"כ אפאוהו איך לא החמיץ בנתיים, ע"ז אמר כי גורשו, שלא הי' שהות והתמהמהות בנתיים בכדי להחמיץ שלזה אמר ג"כ הבצק בה"א הידועה כלומר הנזכר כבר ונכתב עליו שהי' צרורות בשמלותם, כלומר שגם זה הועיל לשלא החמיץ, מכיון שהי' צרור וכבוש כבמכבש, שזה יועיל לו בכל המלאכה שעוסקין בבצק שלא יחמיץ:	NULL
Paaneach Raza, Bo 43	ומושב ב"י וגו', משעת בין הבתרים עד לידת יצחק הי' ל' שנה, ומלידתו עד ירידת יעקב ק"ץ שנה ורד"ו שנה היו במצרים הרי ת"ל שנה ומה שכלל אותן ל' עמם הלא הגזירה לא היתה רק ת' שנה שהם מלידת יצחק ואילך אלא כדי לכלול גאולת אב ובנים שאז יצא אברהם מאור כשדים, וקשה הלא כתיב ואברהם בן ע"ה שנים בצאתו מחרן א"כ לא הי' כי אם כ"ה שנה עד שנולד יצחק לאברהם בן ק' שנה, וי"ל דבסדר עולם יש שפעמיים יצא מחרן ובראשונה הי' בן ע' שנה ואז הי' המראה של בין הבתרים, מהר"ר משה:	Exodus 12:40
Paaneach Raza, Bo 44	ועצם לא תשברו בו, מפני שהפסח נאכל על השובע וא"כ הי' נראה כרעבתנותא, מהר"ר חיים:	Exodus 12:46-47
Paaneach Raza, Bo 45	ולטוטפות בין עיניך וגו', זה שאמר הכתוב כי שם ה' נקרא עליך וגו' ואר"א אלו תפילין שבראש ש"ם נוטריקון "שי"ן "מסיני כי שי"ן של תפילין הלמ"מ וכן הוא נוטריקון "ש "מניחין, כי ג' מאות ימים בשנה מניחין אותן, דשס"ה ימים הם בשנה הוצא משם נ"ב שבתות וי"ג ימים טובים, ד' של פסח, ב' דשבועות, ב' דר"ה, א' דיהכ"פ, ד' דסוכות, הרי י"ג, הרי בין הכל ס"ה נשארו ש' שמניחין בהן תפילין:	Exodus 13:16
Paaneach Raza, Bo 46	ולטוטפ"ת בי"ן עיני"ך בגימט' אלו ארבע בתים:	Exodus 13:16
Paaneach Raza, Beshalach 1	@שמות פרשת בשלח	NULL
Paaneach Raza, Beshalach 2	ובעזרת צוה מעשה רוקח ממולח, נתחיל סדר בשלח:	NULL
Paaneach Raza, Beshalach 3	ויהי בשל"ח, בגימט' ע"ל כרח"ו א"ת הע"ם בגימט' ב"ם ער"ב ר"ב:	Exodus 13:17
Paaneach Raza, Beshalach 4	כי קרוב הוא, פי' ואם יגיעום מצריים תוך ג' ימים להחזירם יחזרו ויאמרו הלא לא בקשנו רק דרך ג' ימים ויחשבו שיקבלו אותן באהבה וברצון ובקל ישובו, משא"כ בדרך רחוקה שלא יוכלו להשיגם רק אחר ג' ימים ולא במהרה ינתקו לשוב בחשבם שלא יקבלום באהבה כיון ששקרו בם, מהר"ר משה:	Exodus 13:17
Paaneach Raza, Beshalach 5	ד"א כי קרוב הוא, פלשתים קרובים למצריים, שנאמר ומצרים ילד את לודים וגו' ואת כסלוחים אשר יצאו משם פלשתים וגו', ואם יראו פלשתים את ישראל יוצאים ממצרים בע"כ של מצריים בנקל יבאו להלחם עמהם ושבו מצרימה:	Exodus 13:17
Paaneach Raza, Beshalach 6	ד"א כי קרוב הוא, הדרך קרוב שכן מצינו ביצחק שרצה לילך למצרים דרך ארץ פלשתים, ג"ן:	Exodus 13:17
Paaneach Raza, Beshalach 7	(ד"א כי קרוב הוא, פי' קריעת י"ס הוא קרוב מאותו צד שנהגם השי"ת שלא הי' צריך לקרוע להם הרבה כי דרך קרוב ומעט בתוכו באותו צד כידוע, משא"כ אם היו עוברים דרך ארץ פלשתים הי' צריך לקרוע כל רוחב ים פלשתים והי' הוא ית' בוחר במיעוט הכרת הנס:	Exodus 13:17
Paaneach Raza, Beshalach 8	וחמושים עלו וגו', במדרש פליגי איכא מ"ד פי' א' מחמשה עלו, שאותן ס' רבוא שעלו לא היו כ"א חלק חמישי ממה שהיו כבר וד' פעמים ככה מתו בג' ימי אפלה, וחד מ"ד א' מחמשים, וחד אמר אחד מחמש מאות, וכן אפלגו בפסוק ושלישים על כלו, ח"א שלשה על כלו, כלומר שהמצריים שרדפו אחר ישראל היו ג"פ נגד כולם, וח"א שלשים, וח"א שלש מאות, ופי' הדבר כי הם סוברים עכ"פ למר כדאי"ל ולמר כדאי"ל שפרעה לקח עמו על כולו של ישראל כפי מה שהיו כבר קודם ימי אפלה, שהרי הוא לא ידע שמתו מהם, והנה הדברים מכוונים, שאלו ג' דעות שבמחנה מצרים הן הן הדעות שבמחנה ישראל גם את זה לעומת זה, מועט כנגד מרובה, באופן דמחנה מצרים היו לדעת כולם בשוה תשעים אלף רבוא, ובהא מר אמר חדא ומר אמר חדא ולא פליגי רק דבמחנה ישראל פליגי, וזהו הדרך, דמאן דסבר פי' ושלישים שלשה שבמחנה מצרים היו על חד של ישראל תלת, הוא הוא שסובר פי' של וחמושים עלו, א' מחמש מאות, שהיו ישראל קודם ימי אפלה ת"ק פעמים ס' רבוא, דהיינו ס' פעמים ת"ק רבוא, שהם ל' פעמים אלף רבוא, וא"כ מצריים שהיו שלש פעמים כנגדן היו צ' אלף רבואות, והאי דאמר ושלישים ר"ל ל' פעמים כנגדן, הוא שסובר וחמושים פירושו א' מחמשים עלו, דהיינו שהיו קודם ימי אפלה רק חמשים פעמים ס' רבוא שהם בין הכל ג' אלפים רבוא, כי ג"פ ס' הוא ג' אלפים, וא"כ פרעה שהוסיף עליהם כחם ל' פעמים דהיינו ל' פעמים ג' אלף רבוא הרי ג"כ צ' אלף רבוא, ומ"ד במחנה מצרים ושלישים פי' ושלש מאות שלקח פרעה נגד כל אחד מישראל ג' מאות הוא שסובר במחנה ישראל וחמושים עלו הוי פי' א' מחמשה שלא היו אף מתחלה כי אם חמשה פעמים ס' רבוא שהן בין הכל ג' מאות רבוא, וא"כ כשהיו מצריים כנגדן שי"ן פעמים ככה יעלו ג"כ צ' אלף רבוא, כי כל עשרה פעמים ככה הם ג' אלף רבוא, והרי שי"ן הוא ל' פעמים עשרה, שהם ל' פעמים ג' אלף רבוא, הרי צ' אלף רבואות, ולכך אמרו ז"ל כשירד הקב"ה אל המצריים על הים ירדו עמו צ' אלף רבואות מלאכי חבלה, דהיינו כמספר המצריים שיחבל כל מלאך א' מהם, מוהר"ר אברהם הלוי:	Exodus 13:18
Paaneach Raza, Beshalach 9	ויקח משה את עצמות יוסף עמו, וקשה למה כתב זה במסע השני כשנסעו מסוכות לאיתם שידבר בו כאן ולעיל במקום ויסעו מרעמסס לסוכות שהוא מסע יום ראשון הי"ל לכתבו, וי"ל דביום ראשון לקח עצמות כל השבטים גם יחד ולא נתן לב עדיין להפריד של יוסף לעצמם לאפס הפנאי עד שהיו בסכות שנתיישב קצת ונפנה להבדילן ויקח את עצמות יוסף עמו לעצמן (ולק"מ שהרי כאן התחלת הענין הוא ויהי בשלח וגו' דקאי אהתחלת יציאתן ביום ראשון שחוזר הכתוב לראש לספר מאורעות ההם, ולא נחם וגו' ויסב וגו', וקאי נמי עלה ויקח משה וגו', שבו בפרק בויהי בשלח לקחן, ובויסעו מסוכות וגו' הוא שמתחיל סיפור מסע יום שני לעצמו וק"ל:	NULL
Paaneach Raza, Beshalach 10	ואל תפן למאמר וה' הולך לפניהם הכתוב אח"כ לתמוה איך לא יהי' זה גם ביום ראשון, דודאי לא הי' צריך לכך, דעד איתם היו בקיאים בדרך אלא שמאז יכנסו במדבר יהי' זה, ועוד דביום ג' כבר הי' מקום שיחזרו למצרים אח"כ לכן וה' הולך וגו', אבל בב' ימים ראשונים עדיין לא הגיע זמן אוקטורין ששלח עמהם שיתבעו שישובו):	NULL
Paaneach Raza, Beshalach 11	ויקח משה, תימה למה לא הומדד משה כאשר מדד שלא זכה שיעלו גם עצמותיו לארץ. וי"ל דיוסף זכה זה בעבור שלא שינה שמו כשנמכר ושאלוהו מי אתה ואמר עברי אני, כדכתיב הביא לנו איש עברי לצחק וגו', ואלו משה בברחו למדין כששאלוהו אמר מצרי אני כדכתיב איש מצרי הצילנו לכן לא זכו עצמותיו לעבור לארץ מיוחדת לעבדים שהן הן כל עצמותו והוי זה מדה כנגד מדה, (אבל לבי נוקפי לחשוב על אדון הנביאים כזאת, וכן הראי' אינו כלום, כי מאן יאמר ששאלוהו, שמא הם מעצמם החזיקוהו בכך, ואעפ"כ לא קשיא דכבר גם מפנים רבים הי"ל ליכנס חיים לולא השבועה שגלוי לפניו ית' טעמה ואין להרהר אחר מדותיו):	Exodus 13:19
Paaneach Raza, Beshalach 12	והעליתם את עצמותי וגו', וקשה כיון שעצמות כל השבטים העלו למה לו ליוסף להשביעם על שלו, וי"ל דגם שלהם לשבועתו הועלו, כי על שלו ושלהם גם יחד השביע, ועוד דשאני עצמותיו שירא שמא יעבדוהו כיון שהי' מלך, מהר"ר יעקב:	Exodus 13:19
Paaneach Raza, Beshalach 13	וה' הולך לפניהם, נכתב זה כדי שלא לתמוה איך ידעו אימת בוקר או ערב כיון שהעננים הקיפום מכל ששה צדדים, לכן הודיענו שבהבדל עמוד ענן ועמוד אש היו יודעים, ותימה צבא מעלה מנא ידעו לומר שירה הא כתיב ונהורא עמי' שרי, וי"ל דאיתא במדרש שיש מלאך א' שחקוק לו אות חסד על כתפו, ובעלות השחר חוזר האות על כתפו מלפניו, ובערב הוא בא לאחריו (מפני כי מדת יום הוא החסד ומדת לילה הוא הדין) ובזה הם מכירים, וזהו שיסד הפייט אות פקידה בוקר:	Exodus 13:21
Paaneach Raza, Beshalach 14	להאיר להם וגו', כלומר שאל תקשה מה נפקותא מה שהאיר בלילה בשעת שינה, לזה אמר ללכת וגו' שהיו הולכים תמיד:	Exodus 13:21
Paaneach Raza, Beshalach 15	ויוגד למלך מצרים, פירש"י איקטורין שלח עמהם וכו', ותימה דהא פירש"י וישובו, לצד מצרים היו מתקרבין כל ג' ימים וא"כ לא היו בסוף יום ג' ממצרים כ"א מהלך יום א' ואיך הגידו לפרעה שלא יחזרו ומנא ידעו, וגם המצריים למה רדפו יום חמישי וששי הא לא רחקו כ"א מהלך יום א' וי"ל דביום ראשון מהלך ג' ימים באו ובשני חזרו לאחוריהם מהלך יום א' להטעות את פרעה ובהשכמת יום ד' כשראו האוקטורין שאינם חוזרים הלכו הם הכל ביום א' שהוא יום ד' והגידו ויום ה' רדפו המצריים, מהר"ר משה בשם מוהר"ר יעקב:	Exodus 14:5
Paaneach Raza, Beshalach 16	עוד פירש"י ובשביעי אמרו שירה, ותימה דהא סוף פ' שלח פי' שבאו ח' חוטין בציצית נגד ח' ימים ששהו ישראל על הים עד שאמרו שירה, וי"ל דהתם חשוב גם לערב פסח שהוא יום שחיטת הפסח, וגם חופשה ניתן להם אז וגם נהרגו הבכורים, מהר"ר יעקב, אורליינש:	Exodus 14:5
Paaneach Raza, Beshalach 17	כ"י בר"ח, בגימט' עמלק:	Exodus 14:5
Paaneach Raza, Beshalach 18	מה זאת עשינו כי שלחנו וגו', וקשה ע"י המכות ע"כ יצאו ולא שלחום הם, וי"ל דאמרו לפחות הי' לנו להתנות שיעבדונו בכל מקום שהם, ומעבדנו דייקא, שזה שלחנום אנחנו, רי"ח:	Exodus 14:5
Paaneach Raza, Beshalach 19	הלא זה הדבר וגו', וקשה היכן דברו כזה (וי"ל דזה נכלל ג"כ בולא שמעו אל משה וגו', כלומר מכללות של שתים אלה ביחד לא שמעו, דהיינו שהיו קצרי רוח דעת ויראת ה' שלא האמינו ושיערו שימותו במדבר ולכן טענו טוב לנו עבודה קשה עבוד את מצרים, וזה ולא שמעו וגו', כי מקוצר רוח בחרו בעבודה קשה:	Exodus 15:2
Paaneach Raza, Beshalach 20	ויסר את אופן מרכבותיו, וקשה אופני לשון רבים מבע"ל, וי"ל דאדרבא אם סרו כל אופני המרכבה היתה נגררת בשוה ולא הי' צער כ"כ, לכן לא הסיר כי אם אופן אחד באמת מפני שהאחרים רצים וזה נגרר מתחבטת המרכבה בקפיצה ודילוג ביותר והגוף משתבר ומצטער הרבה ואברים מתפרקין, מוהר"ר משה:	Exodus 15:2
Paaneach Raza, Beshalach 21	זה אלי ואנוהו, אע"פ שלא ראוהו שייך לומר לשון זה כמו כי זה משה האיש, רשב"ם:	Exodus 15:2
Paaneach Raza, Beshalach 22	ה' איש מלחמה ה' תיבות בפסוק וכן בפסוק ה' ילחם לכם נגד ה' מיני זיין כאלו נלחם להם בם:	Exodus 15:3
Paaneach Raza, Beshalach 23	עד יעב"ר בגימט' זה"ו ירד"ן:	NULL
Paaneach Raza, Beshalach 24	תביאמו, פירש"י שנתנבא שלא יכנס לארץ, וקשה הלא כבר א"ל הש"י עתה תראה ודרשו ולא במלחמת ל"א מלכים, ועוד הא אמר ליתרו נוסעים אנחנו אל המקום וגו' שכלל עצמו עמהם ותירץ מהר"ר יעקב דכאן ניבא ולא ידע מה ניבא (אבל לא קשה הלא מכח עתה תראה ידע שלא יכנס ואיך א"כ כלל עצמו בנוסעים אנחנו דעתה תראה לאו גזירה הוא כפירש"י בבהעלותך):	NULL
Paaneach Raza, Beshalach 25	מקדש ה' כוננו ידיך, מכאן אמר ר"י שראו המקדש מתוקן בבנינו כאשר הי' עתיד להבנות:	Exodus 15:17
Paaneach Raza, Beshalach 26	ה' ימלך וגו', הקדים השם למלכות ודוד אמר ימלך ה' לעולם להמליכו קודם שיזכיר את שמו, אלא משה נקט הכי שלא לסמוך האזכרה לכי בא סוס וגו', ודוד כיון שלא יהא סמוך לדרך רשעים יעות שלפניו, ושניהם לד"א נתכונו שלא יחול ה' על הרעה, כדכתיב לעות אדם בריבו ה' לא צוה:	NULL
Paaneach Raza, Beshalach 27	"וימתקו "המים "שם "שם ר"ת בגימט' תור"ה:	Exodus 15:25
Paaneach Raza, Beshalach 28	שם שם לו חוק ומשפט, פירש"י שבת ופרה וכו', וקשה הא אמרו תבא פרה ותכפר על עון העגל, משמע שלא נצטוו בפרה עד אחר עון העגל, אורליינ"ש, (וי"ל דודאי מקמי שמיא גליא ומתחלה נתכוין בציווי' על כך אלא שאח"כ נודע להם הדבר, ועוד כדי שלא יבא זה לפקפוק ידיעה ובחירה איך יוחלטו שניהם כא' נאמר כי מתחלה נצטוית עכ"פ ואחר החטא בעגל ייעד שיהי' ציווי זה כפרה עליו, אבל גם אם לא היו חוטאי' בזה הי' הציווי מצווה ועומד עכ"פ):	Exodus 15:25
Paaneach Raza, Beshalach 29	כי אני ה' רופאך, אם לא שם מחלה רפואה מנין, וי"ל שאני רופאך כבר קודם המחלה שלא תבא, הר"ר יעקב:	Exodus 15:26
Paaneach Raza, Beshalach 30	(ד"א כי אני ד' רופאך שעכ"פ אם תהי' מחלה אני אני הוא שמוטל עלי לרפאותך ממנה כי בודאי לא אתנך לכלה, לא ארפך ולא אעזבך א"כ מוטב שלא אשים עליך מחלה מתחלה ולא אצטרך לרפאותך):	Exodus 15:26
Paaneach Raza, Beshalach 31	א"ל מדב"ר סי"ן, בגימט' הסנ"ה, שהוא הוא סיני ונתוסף לו אח"כ היו"ד כנגד י' דברות:	NULL
Paaneach Raza, Beshalach 32	מחספ"ס בגימט' רמ"ח שנבלעו בכל האברים:	NULL
Paaneach Raza, Beshalach 33	איש אל יותר ממנו עד בקר, ותימה דא"כ היאך נסתפקו מ' שנה ממן שבכליהם הרבה ימים כדאיתא בגמ' ושמא כיון שכבר פסק מלירד אין עוד קפידה בהותרה, דלפני זה נאסר משום שהי' להם בטחון:	Exodus 16:19
Paaneach Raza, Beshalach 34	אל יצא איש ממקומו, וקשה דמהאי קרא דרשינן איסור הוצאה בשבת דקרינן בי' אל יוציא וא"כ איך הוציאו כליהם בט"ו באייר שהי' בשבת והיו בו במסע כדאמרינן בפ' ר' עקיבא, ואף למ"ד התם אתחומין לא אפקוד ושפיר הלכו בשבת מ"מ הרי אהוצאה אפקוד מהאי קרא, וי"ל דלהאי מ"ד כמו דאתחומין לא אפקוד כך אהוצאה לא אפקוד, וקרא דאל יצא אל יוציא לאחר מ"ת נאמר ומשום דשייך למילי דמן כתבי' הכא, מהר"ר יעקב:	NULL
Paaneach Raza, Beshalach 35	"למען "יראו "את "הלחם ר"ת אלי"ה לומר כי לעתיד בבא אליהו יראנו:	Exodus 16:32
Paaneach Raza, Beshalach 36	את המן אכלו ארבעים שנה, פירש"י והלא חסר ל' יום שהרי בחמשה עשר באייר ירד תחלה ובט"ו בניסן פסק שנאמר וישבות המן וגו', וקשה הלא בסמוך פי' שבז' באדר פסק, וי"ל דבז' באדר פסק קצת ונסתפקו במן שבכליהם עד ט"ו בניסן ואז פסק לגמרי:	NULL
Paaneach Raza, Beshalach 37	את המן אכלו עד בואם וגו', מכאן מוכח שפסק השלו מדקאמר את המן אכלו, משמע ולא השליו, וא"כ אל תקשה היאך כתיב וישובו ויבכו וגו' הא כתיב ותעל השליו, דכבר פסק, מהר"ר משה:	NULL
Paaneach Raza, Beshalach 38	עד בואם אל ארץ נושבת, ושלא תתמה הלא ארץ סיחון ועוג נושבת היתה ואעפ"כ לא פסק המן עדיין שנאמר וישבות המן ממחרת וגו' לכן קאמר עוד עד בואם אל קצה ארץ כנען לומר שאותה דוקא קרא ארץ נושבת:	Exodus 16:35
Paaneach Raza, Beshalach 39	ומטך אשר הכית בו את היאור, וקשה הא אהרן הכה את היאור (ותמה אני על בעל קושיא זו הלא בוארא כתיב בדברי משה הנה אנכי מכה במטה אשר בידי וגו' וסמיך לי' אמור אל אהרן קח את מטך וגו' ויותר הי"ל להקשות קושייתו שם שתיכף וסמוך לפסוק ראשון יצא שוברו עמו לסתרו, אלא שמהכא ומהתם ל"ק כלל כי יבא הכתוב השלישי ויכריע ביניהם, הוא מ"ש שם אח"כ בענין ויעשו כן משה ואהרן וגו', לומר כי בהיות שמשה הוא המצוה לאהרן וגם לולא שהיאור הגין על משה היתה המכה בא ע"י עצמו כדפירש"י שם לכן שפיר נקרא ע"ש שניהם כאחד טובים, ולזה נתכוין רש"י ז"ל בעצמו ובכבודו שם בכתבו זאת להודיענו יישוב זה:	Exodus 17:5
Paaneach Raza, Beshalach 40	ויב"א עמל"ק בגימט' מ"ר לרמז על אגג שנאמר אכן סר מר המות:	Exodus 17:8
Paaneach Raza, Beshalach 41	עם ישראל ברפידם, בגימט' ונרפו ידיהם ממצות:	NULL
Paaneach Raza, Beshalach 42	והי' כאשר ירים משה ידו וגו' פי' עם המטה שהי' סימן להם כדרך שנושאין גם במלחמה ובראשו דגל לסימן, וזהו ה' ניסי, דגל שלי ולכן וידי משה כבדים ויקחו אבן וישימו תחתיו וגו' כדי שיראו הסימן למרחוק, מהר"ר משה:	Exodus 17:11
Paaneach Raza, Yitro 1	@שמות פרשת יתרו	NULL
Paaneach Raza, Yitro 2	וישמע יתרו פירש"י ז' שמות נקראו לו, וקשה והא איכא רכב דכתיב ומבני רכב חותן משה, וי"ל דלא חשיב כ"א הנמצאים בחומשי התורה (וישמ"ע יתרו בגימט' הו"א כ"י נקר"ע לה"ם הי"ם וכ"י נלחמ"ו מעמל"ק):	Exodus 18:1
Paaneach Raza, Yitro 3	אחר שילוחיה, ב' שילוחין, א' שפטרה בגט כמו ושלחה מביתו שע"כ אף כשחזר יתרו והביאה לו לא החזירה לתשמיש שלכך ותדבר מרים וגו', וא' ששלחה לבית אביה:	Exodus 18:2-3
Paaneach Raza, Yitro 4	גר הייתי, מה שלא אמר בשעת קריאת שם זה כי גר אני וגו', ואמר בלשון עבר מפני כי קודם שהי"ל בנים הי' בגירות אבל משנולד לו בן לאדם אין נקרא לו עוד גירות, כי פשיטא שלא ילך מבניו, רי"ח בשם רבינו ממורא"ט:	Exodus 18:3
Paaneach Raza, Yitro 5	ושם האחד אליעזר כבר אמרו במדרש שהתנה יתרו עם משה שיתן בנו ראשון לע"ז והוא גרשום שמטעם זה לא הזכיר עליו את השם ואמר עליו סתם גר הייתי בארץ נכרי', נכרי' ע"ש לשון עבודה זרה, והע"ז היא זרה לעובדי', לאפוקי על אליעזר בן שני קרא שם שמים כי אלהי אבי וגו' כי הוא הי' לשמים, ושקראו כן ע"ש אליעזר בן הורקנוס שיצא ממנו אשר עליו מצא משה להקב"ה אומר אליעזר בני אומר פרה בת שתים ועגלה בת שנתה, וחינן משה שיצא ממעיו ונעתר לו הקב"ה, לוי:	Exodus 18:4
Paaneach Raza, Yitro 6	ויצילני מחרב פרעה, פירש"י נעשה צוארו כעמוד של שיש, וקשה הא פירש"י לעיל על מי ישים אלם, מי עשה לפרעה אלם שלא נתאמץ במצות הריגתך הלא לא יכול לו ומה הי"ל להתאמץ, וי"ל דמ"מ הי"ל להתאמץ ולבקש שאר הריגות שלא בחרב או שלא מצוארו (וכבר פירשתי בפ' שמות ומתיישב גם זה במה שפירשתי אני שם):	Exodus 18:4-5
Paaneach Raza, Yitro 7	וישתחו וישק לו, פירש"י כשהוא אומר איש לרעהו מי הקרוי איש זה משה וקשה הלא גם יתרו נקרא כן כדכתיב ויואל משה לשבת את האיש וי"ל דשאני הכא דכתיב כי זה משה האיש דממ"נ א' מיותר א"ו אתי לדרשא שבשם עצם שלו יקרא איש, אבל ביתרו כתיב איש לחוד אין הוכחה שיהא נקרא בעצם איש:	Exodus 18:7
Paaneach Raza, Yitro 8	ויחד יתרו, פי' שייחד שם שמים ונתגייר ויח"ד יתר"ו ע"ל בגימט' דהעל"ה כ"ל בשר"ו חדודי"ם:	Exodus 18:9
Paaneach Raza, Yitro 9	אשר הציל אתכם מיד מצרים על משה שניצול מגזירת השלכת היאור ומיד פרעה במאמר לא תוסיף ראות פני ואח"כ אשר הציל את העם:	Exodus 18:10
Paaneach Raza, Yitro 10	עתה ידעתי, פירש"י מכירו הייתי לשעבר ועכשיו ביותר פי' כי כבר פירש מע"ז כדפירש"י בפ' שמות אצל ולכהן מדין ז' בנות וגו', ועדיין גר תושב אוכל נבילות הי' ועכשיו נתגייר לגמרי, ד"א כבר פי' מע"ז של מדין ועתה מכל ע"ז שבעולם שזהו מכל האלהים, ר' משה הדרשן:	Exodus 18:11
Paaneach Raza, Yitro 11	וישב משה לשפוט, שהיו מדיינים הרבה בביזת הים שהראשונים לקחו המשובח והרוב והאחרונים טענו לחלוק עמהם וכיוצא:	NULL
Paaneach Raza, Yitro 12	ויהי ממחרת, בלקח טוב פי' ממחרת הסעודה כלומר שלא רצה להורות ביום המשתה:	Exodus 18:13
Paaneach Raza, Yitro 13	נבול תבול, כמו נפול תפול, וכן כנבול עלה מגפן, ד"א לשון ערבוב וקול הומיה כמו ונבלה שם שפתם, או לשון זקנה כמו אחרי בלותי שתזקין בלא עתך:	Exodus 18:18
Paaneach Raza, Yitro 14	גם אתה פירש"י לרבות אהרן וחור, וקשה למ"ד לאחר מ"ת בא יתרו אשר דעת רש"י נוטה אחריו לא הי' חור קיים אז שהרגוהו במעשה העגל, וי"ל דתרי חור הוו וי"א דבמכילתא לא גרסינן חור ואפ"ל דנקטי' אגב גררא, שאם הי' קיים גם הוא הי' נובל, לוי:	NULL
Paaneach Raza, Yitro 15	מן הבקר עד הערב למדו מכאן דכל דיין שדן דין אמת וכו', וקשה דהא אמרו במועד קטן אמטיי' למערתא דחסידי ולא קבלוה למערתא דדייני וקבלוה, אלמא דייני לא עדיפי כולי האי וי"ל דהתם בדייני שאינם מומחין מיירי, הר"י:	NULL
Paaneach Raza, Yitro 16	שונאי בצע פי' ששונאים ממון עצמם בדין שאף אם א' מבע"ד אלים ומגזם לדיין לגזול ממונו אם יחייבהו בדין ומוחזק שכן יעשה ואעפ"כ אל יחוס עיניו על שלו ויעשה משפט:	Exodus 18:21
Paaneach Raza, Yitro 17	וילך לו אל ארצו וסמיך לי' בחדש השלישי מכאן אמרו הגיורת והשבוי' והמשוחררת לא ינשאו ולא יתארסו עד ג' חדשים, שהרי עתה היו בישראל שלשתן, שהיו גרים ויצאו משעבודם ומשביים ונתאחרו נשואיהן לו ית' עד ג' חדשים:	Exodus 18:27-19:1
Paaneach Raza, Yitro 18	באו מדבר סיני, מה שלא נתנה התורה בא"י הקדושה, שלא יהא פתחון פה לאומות לומר לא נתנה לנו, ועוד שבא"י הי' זה רץ לשדהו וזה לכרמו והיתה התורה בטלה, לכן נתנה במדבר מקום שהיו כולם פנוים ובטלים וזה שאמרו לא נתנה התורה אלא לאוכלי המן:	Exodus 19:1-2
Paaneach Raza, Yitro 19	ויסעו מרפידים פירש"י להקיש נסיעתן וכו', הרי שנכתב לשבח, וקשה דהא אמרינן למה נקרא רפידים שרפו ידיהם מן המצות (וי"ל דתרווייהו אתנהו דבהיותם ברפידים רפו ידיהם שלכן בא עמלק וילחם וגו', לאפוקי אח"כ בנסעם משם נסעו בתשובה שלכן הוצרך לכתוב האי ויסעו, וזה שהוצרך להקיש נסיעתן לביאתן דאם לא רפו ידיהם בנתיים פשיטא שנסעו בכשרות, מהיכי תיתי איפכא עד שהוצרך להקישן ופשוט הוא):	Exodus 19:2
Paaneach Raza, Yitro 20	ממלכת כהנים, מכאן אמרו כל ישראל בני מלכים הם והראי' שהמלאכים נתנו בראש כל א' מישראל ב' כתרים:	Exodus 19:6
Paaneach Raza, Yitro 21	כל הנוגע בהר מות יומת, קצת תימה איך ימות שם במקום השכינה, וי"ל דאין קפידא שהרי גם נדב ואביהוא מתו לפני ה':	Exodus 19:12
Paaneach Raza, Yitro 22	כי סקול יסקל או ירה יירה, וקשה דבפירש"י ובפרק נגמר הדין ילפינן מהכא שהיו דוחפין לנסקל גובה ב' קומות מדכתיב ירה יירה ואח"כ השליכו עליו אבן לסקלו וא"כ הו"ל למכתב ירה יירה תחלה דקאי אדחיפה ואח"כ סקול יסקל דקאי אהשלכה, וי"ל דשמעינן בעלמא דדחיי' קודמת מדכתיב וסקלתם באבנים ומתו, דשמעינן שבסקילה ימותו א"כ כאן אין עוד לטעות לומר דדחיי' מאוחרת דאיך תהי' דחיי' לאחר מיתה רק דכאן כתיב הכי משום דכתיב או דלא מיירי כאן בסתם דין סקילה לעשות שניהם ירייה וסקילה, לכן כתיב סקילה קודם לקבוע בו לעונש או הא או הא ובדרך לא זו אף זו דאפי' ירייה שהיא גדולה יותר יכול לעשות לו, הר"ר שמואל מפלייזא:	Exodus 19:13
Paaneach Raza, Yitro 23	אל תגשו אל אשה וגו', אמרו חז"ל ג"ד עשה משה מדעתו והסכים הקב"ה ע"י וא' מהן הוא שפירש מן האשה שדרש ק"ו מהכא, ומה ישראל שלא נדבר עמהם אלא לפי שעה, וגם קבע להם זמן וגבול ואמר להם אל תגשו וגו', אני שנדבר עמי כל שעה ושעה ולא קבע לי זמן לא כ"ש וקשה דאדרבא היא הנותנת מכיון שקבע להם זמן ובודאי ידבר עמם לכן נאסרו אבל משה דבכל שעה אינו אלא ספק אימא לא, וי"ל דמה שנאסרו ג"י היינו שאפי' פליטת ש"ז לא יהי' ביום הדיבור כי ג' ימים אפשר לפלוט, דאלו לשלא ישמשו ביום הדבור הי' מספיק לפרוש אותו יום לבד, וא"כ אפי' לפליטה יש לחוש, א"כ הוי שפיר ק"ו בזה האופן, דכ"ש משה דכיון שלא קבע לו זמן הי' אפשר הדבור לבא ביום התשמיש ואף בשעת תשמיש כ"ש דלא יתכן:	NULL
Paaneach Raza, Yitro 24	ויתיצבו בתחתית ההר פירש"י מלמד שכפה עליהם ההר כגיגית וכו', וקשה למה הי' צריך לזה הא אמרו כל אשר דבר ה' נעשה והיו מקבלים מאהבה מתחלה, ועוד שהרי ירדו מה"ש וקשרו לכל א' שני כתרים על כך, וי"ל דכך אמרו כל אשר דבר ה' כבר במרה נעשה, אבל מעתה שמא ידבר חמורות ולא נוכל לקבלם א"נ כשיראו האש הגדולה שמא יחזרו בהם לכן כפה עליהם ההר כגיגית, והר"ר אלחנן תירץ דבאמת חזרו ממה שאמרו לעיל כל אשר דבר ה' נעשה, ולכן באמת לא כתיב אשר ידבר אלא אשר דבר, וראי' מפרק ר' עקיבא שאמרו שם כל דבור ודבור שיצא מפי הקב"ה חזרו ישראל לאחוריהן י"ב מילין וכו', ומה שקשרו להם כתרים לאו אהך מלתא קשרו שעדיין היו מסופקין, והראי' שקשרו להם ב' כתרים א' כנגד נעשה וא' כנגד נשמע, והרי עד כה לא כתיב רק אשר דבר ה' נעשה לבד אלא אח"כ בסוף הענין אמרו נעשה ונשמע כדכתיב בפרשה האחרת, ועלה דההוא קשרו להם הכתרים שאז היו כשרים לגמרי, מהר"ר חיים:	Exodus 19:17-18
Paaneach Raza, Yitro 25	ויתיצבו בתחתית ההר, בפ' ר' עקיבא אמרו מלמד שכפה עליהם ההר כגיגית מכאן מודעה רבה לאורייתא, פי' תשובה גדולה לעוברים עליה שיוכלו להשיב אנוסים היינו בקבלתה, וקשה הא אמרינן בנדרים ובסוטה לעברך בברית וגו' שכרת משה ברית עם ישראל על התורה ומצות והשביען על כך ואיך א"כ יאמרו באונס קבלנוה, וי"ל דכ"ז על כרחם הי', ועי"ל דהתם בע"ז קאמר אבל בכל התורה לא קבלוה ברצון ומאהבה עד מרדכי ואסתר מפני הנס:	Exodus 19:17-18
Paaneach Raza, Yitro 26	והר סיני עשן כלו, קשה בפ"ק דיומא מנו באש מן השמים שאינו מעלה עשן בתוך ה' דברים שנאמרו בו, וי"ל דהתם באש של מערכה אבל הכא כדי ליראם שאני, מצאתי:	Exodus 19:18
Paaneach Raza, Yitro 27	וידבר אלהים את כל הדברים וגו', פירש"י מלמד שאמר הקב"ה י' דברות בדיבור א' וכו', וקשה מאי רבותא א"כ בזכור ושמור שנאמרו בדבור א' והלא כולם בדבור א' נאמרו וי"ל דמתחלה כללן בדיבור א' לישראל ואח"כ חזר ופרשן כ"א לעצמו ואנכי ולא יהי' לך גם ישראל שמעו, והאחרים למשה לבדו חוץ מזכור ושמור שנאמרו אף בחזרה למשה בדיבור א', אבל קשה הלא אפי' א' א' לעצמו לא יכלו לשמוע ואמרו למשה דבר אתה עמנו וגו' כ"ש איך שמעו כולם מתחלה בדיבור א', לכן י"ל דבכללות נמי לא שמעו הם כ"א ב' הראשונים, מהר"ר חיים:	NULL
Paaneach Raza, Yitro 28	וידבר אלהים וגו', בפסוק זה יש ז' תיבות וכ"ה אותיות וכן בפסוק בראשית וכן יהא שמי' רבה וכו', לומר שכל העונה יהא שמי' רבה בכל כחו כאלו נעשה שותף להקב"ה במעשה בראשית של ז' הימים וכאלו קבל הדברות מפי ית':	Exodus 20:1
Paaneach Raza, Yitro 29	וידב"ר אלהי"ם א"ת כ"ל הדברי"ם האל"ה לאמ"ר, בגימט' ככ"ל מ"ה שבכת"ב ושבע"ל פ"ה:	NULL
Paaneach Raza, Yitro 30	אנכי וגו', אמרו חכמים ז"ל כששמעו אנכי ולא יהי' לך חזרו לאחוריהן י"ב מיל והחזירום מלאכי השרת כדכתיב מלאכי צבאות ידודון ידודון, וקשה הא סבירא לן דבשבת ניתנה תורה ואיך הלכו כ"כ בשבת, וי"ל דמכיון שהוקפו בענני כבוד הרי כאלו היו בחצר א', מר' יוסף:	NULL
Paaneach Raza, Yitro 31	והקשה הר"ר יצחק הבחור הלא בפסוק זה כתיב מלכי ולא מלאכי באל"ף ואיך ילמוד א"כ מזה שמלאכי השרת החזירום, ותירץ דנמצא במדרש כי מיכאל וגבריאל מלכי המלאכים הם כלומר החשובים והגדולים שבהם והחזירון הם:	NULL
Paaneach Raza, Yitro 32	לא יהי' לך וגו' פי' שלא תחשוב שם דמות וצלם באלהות, וקשה הא כתיב בצלם אלהים עשה וגו', וי"ל דבאה אתנחתא תחת בצלם להפרידו מאלהים, וה"ק בצלם חשוב שהי' לו ית' לזה עשה אלהים את האדם:	NULL
Paaneach Raza, Yitro 33	"לא "יהיה "לך "אלהים, ר"ת אליל:	Exodus 20:3
Paaneach Raza, Yitro 34	תמונ"ה, בגימט' פרצו"ף אד"ם ואש"ר באר"ץ, בגימט' אל"ו ההרי"ם והגבעו"ת:	NULL
Paaneach Raza, Yitro 35	מתח"ת בגימט' ז"ו שילשו"ל קט"ן:	NULL
Paaneach Raza, Yitro 36	תמונ"ה אש"ר בשמי"ם גימט' ול"א בדמו"ת המשמשי"ם לפנ"י:	Exodus 20:4
Paaneach Raza, Yitro 38	ד"א בשמי"ם ר"ת "בדמות "שמש "מזלות "ירח "מלאכים, באר"ץ, "בהמה "אדם "רמש "צפור:	Exodus 20:4
Paaneach Raza, Yitro 38	לא תשא, י"ז תיבות בפסוק לומר שכל הנשבע לשקר עובר על כל הלוחות הכתובים י"ז פעמים בתורה, ועל תורת משה דכתיב יז"פ בכל המקרא, וכופר באלהי אברהם ואלהי יצחק ואלהי יעקב הכתובים י"ז פעמים:	Exodus 20:7
Paaneach Raza, Yitro 39	(והטעם בכל אלה עצמם שכתובים יז"פ כמנין טו"ב הוא כי טוב וישר ה' ונתן לקח טוב על הלוחות לזרע האבות שהיו טו"ב לפניו ועשו הטו"ב והישר):	NULL
Paaneach Raza, Yitro 40	שו"א, ז' תגין על השי"ן כנגד ז"פ כזב שבירמי', וז"פ תועבת נפשו שבמקרא, וז' פעמים חטאתיכם שבתוכחה וז"פ עונותיכם מלא במקרא, וז' שמות ליצה"ר ולגיהנם (ועוד הרמז שבשעה שנאמר לא תשא וגו' נזדעזע כל העולם הנברא בז' ימים ורצה לשוב לתהו, ועוד דבזה הוא משים לשוא ולבטלה כל ז' כתרים דהיינו כתר תורה כהונה ומלכות ושם טוב הרי ארבע ושלשה זירי שלחן מזבח וארון:	NULL
Paaneach Raza, Yitro 41	זכור את יום וגו', אמרו ז"ל זכור ושמור בדיבור א' נאמרו, וכן מחלליה מות יומת וביום השבת שני כבשים, וכן לא תלבש שעטנז וגדילים תעשה לך, וכן ערות אשת אחיך וגו' ויבמה יבא עלי', וקשה בשלמא כלהו משום דהוו תרי מילי דסתרו אהדדי, שבכולם הותר האיסור עצמו, כגון חילול שבת הותר בהקרבה וכן כולם אבל זכור ושמור מאי הפניות אית בהו ומפני מה נכללו, זכו"ר ושמו"ר הרי באו אותיות ז"ך תחת אותיות ש"ם, לומר כי שם זך וטוב ניתן לו כדכתיב שם עולם אתן לו טוב מבנים ובנות, ד"א רמז כי שמן זית זך מובחר לנר שבת כי מנהג שתי נרות לשבת הם נגד זכור ושמור:	NULL
Paaneach Raza, Yitro 42	"את "יום "השבת "לקדשו ר"ת איה"ל לרמז שכל ראשי המלאכות של שבת כלומר האבות מלאכות נלמד מאהל המשכן:	Exodus 20:10
Paaneach Raza, Yitro 43	זכור" את" יום" ס"ת רת"ם, שהמחלל את השבת מאכילין אותו גחלי רתמים, זכור את יום השבת וסמיך לי' כבוד אב ואם, לומר שמ"מ יהא זהיר ולא יציית להם לחללו כענין איש אמו ואביו תיראו ואת שבתותי תשמורו, ד"א לומר ששקולין, וכן מצינו ברבקה ג"פ מטעמים נגד ג' סעודות שבת ששקול כבוד אב ואם לזה:	NULL
Paaneach Raza, Yitro 44	יאריכון ימיך, יאריכו מבע"ל, אלא כלומר שאביך ואמך הם יאריכו את ימיך, שכשתכבדם יבקשו תמיד רחמים עליך, מהר"ר משה:	Exodus 20:12
Paaneach Raza, Yitro 45	לא תנאף בין ביד בין ברגל (ל"א תנא"ף בגימט' א"ף דר"ך האברי"ם:	Exodus 20:13
Paaneach Raza, Yitro 46	ל"א תנא"ף, ל"א ת"ן א"ף, שבזה מטיל אף בינה ובין בעלה שאוסרה עליו, א"נ אזהרה לקושרין את האיש במכשפות מבלי יוכל לשמש ומטילין שנאה ביניהם, הר"ר שמואל מפלייזא:	Exodus 20:13
Paaneach Raza, Yitro 47	ובתרגום ירושלמי יפרש ע"ז לא תחבול רחים ורכב:	NULL
Paaneach Raza, Yitro 48	וכל העם רואים וגו' דרך פשט הוא שמיעה כמו וירא יעקב כי יש שבר במצרים או כדרך שרואין רוח הדבור בעת הצנה יוצא מן הפה, ד"א שאפי' סומין נפתחו, מצאתי:	NULL
Paaneach Raza, Yitro 49	וזבחת עליו, פי' אצלו כמו ועליו מטה מנשה:	Exodus 20:21
Paaneach Raza, Mishpatim 1	@שמות פרשת משפטים	NULL
Paaneach Raza, Mishpatim 2	ובעזר משביע חלב חטים, נתחיל סדר ואלה המשפטים:	NULL
Paaneach Raza, Mishpatim 3	ואלה" המשפטים" אשר" ס"ת מר"ה, כי דינין במרה אפקוד, וסמך דינין לעבודה כי שניהם משלשה רגלי העולם:	Exodus 21:1
Paaneach Raza, Mishpatim 4	לפניהם, פירש"י ולא לפני עכו"ם, וקשה תיפוק לי' מכי לא כצורנו צורם וגו', וי"ל דצריכי דסד"א דוקא כשאין דנין כדיני ישראל קמ"ל אף כשדנין כדיני ישראל וקשה משפטים בל ידעום ל"ל, וי"ל דההוא לאו בדינין איירי רק בשאר מצות התורה:	NULL
Paaneach Raza, Mishpatim 5	כי תקנה עבד עברי פירש"י או אינו אלא עבד של עברי דהיינו כנעני שלקחתו מישראל, וקשה הרי כנעני הוא מז' אומות שמצווין עליהם לא תחי' כל נשמה, וי"ל דל"ד כנעני אלא משאר אומות שלא מז' עממין וכל עבד נקרא ע"ש כנעני כיון דבכנען כתיב עבד עבדים יהי' לאחיו, ותימה היאך תיסק אדעתין דבאינו עברי איירי הלא אין שייך להיות נרצע משום אוזן ששמעה בסיני וכו' דאיהו לא בסיני הי', וי"ל דאז לפי הטעות ההוא אה"נ דלא היינו אומרים טעם זה ברציעה:	Exodus 21:2
Paaneach Raza, Mishpatim 6	אם בגפו יבא וגו', דכשהוא פנוי חיישינן כשימסור לו שפחה כנענית יאהבנה ולא ירצה לצאת כי אין אדם מוצא נחת רוח אלא מאשתו ראשונה ועי"כ יהא נרצע ועבדו לעולם, והקב"ה אמר כי לי ב"י וגו', לאפוקי אם בעל אשה הוא אין לחוש להכי, או כל פנוי שיראה שפחה יפה ימכור עצמו כדי שתמסור לו, רי"ח, מהר"ר משה:	Exodus 21:3
Paaneach Raza, Mishpatim 7	ויצאה אשתו עמו, פירש"י מגיד הכתוב וכו' חייב במזונות אשתו ובניו אע"פ דהכא לא כתיב רק אשתו מ"מ מה שסתם כאן פי' בבהר סיני דכתיב התם ויצא הוא ובניו (א"נ מכיון שחייב במזונות אשתו ה"ה בניו ומכ"ש דמהיכא יהא להם, א"נ וי"ו דויצאה אשתו לרבות בניו דאל"כ תצא אשתו עמו מבע"ל):	Exodus 21:3-4
Paaneach Raza, Mishpatim 8	מרצ"ע בגימט' ת' נגד ועבדום ועינו אותם ת' שנה שהקב"ה הוציאם משם מפני כי לי ב"י וגו' ואזנו של זה שמעה כך וגנב עד שנמכר עי"כ או מכר עצמו:	Exodus 21:6
Paaneach Raza, Mishpatim 9	את אזנו, פירש"י אוזן ששמעה וכו', וקשה א"כ בכל מצות התורה הי"ל להרצע בעברו מטעם זה (וי"ל דבזה דוקא מוציא א"ע מתחת יד הקב"ה לגמרי שבוחר בעבדות לעבדים מהיות עבד להקב"ה לכן ירצע זה בפרטות):	NULL
Paaneach Raza, Mishpatim 10	כי ימכר איש את בתו פירש"י בקטנה הכתוב מדבר דאלו בגדולה ק"ו ומה מכורה כבר וכו' וקשה בלאו הק"ו ידענא דמשהביאה סימנים א"י למכרה מדאצטריך היקשא דלאמה דמעשה ידיה לאביה, דאם הוא יכול למכרה השתא זבוני מזבין לה מעשה ידי' מיבעי', וי"ל דהו"א לעולם יכול למכרה והיקשא אתא להיכא שהשיאה ונתגרשה דאז באמת עכ"פ לא יכול למכרה עוד ומעשה ידיה שלו לכן אצטריך ק"ו:	NULL
Paaneach Raza, Mishpatim 11	ויצא"ה חנ"ם בגימט' סימנים:	NULL
Paaneach Raza, Mishpatim 12	מכה איש ומת, פירש"י אם לא נאמר וכו' שומע אני הכאה בלא מיתה, וקשה א"כ כההוא ס"ד מה הי' חילוק בין אביו לשאר כל אדם וי"ל דבמכה איש ה"א במכה בלא מיתה אבל דוקא כשיש בו כדי להמית, ואלו באביו אף כשאין בו כדי להמית, מהר"ר יעקב:	Exodus 21:12
Paaneach Raza, Mishpatim 13	והאלהים אנה לידו, פירש"י הקב"ה מזמנן לפונדק א' וכו' וקשה אכתי משפט מעוקל הוא דעל הראשון שהרגו בשוגג בלא עדים לא מחייב עתה גלות עדיין שהרי בלא"ה על השני שבפונדק גולה, וי"ל דהאי שני גברא קטילא הוא מכיון שהוא כבר הרג במזיד ונפרע לו הגלות של ראשון בזה, אבל קשה הלא זה שהרג במזיד משפטו מעוקל דאלו הוו עדים הוה בסייף ועתה שמת במה שהלה נופל עליו הוי בסקילה החמורה, וי"ל שנופל עליו וסכין בידו והרגו בסכין קאמר דהוי כעין סייף:	Exodus 21:13
Paaneach Raza, Mishpatim 14	מעם מזבחי וגו', וקשה מה ראה יואב לתפוס בקרנות המזבח וכי לא ידע האי קרא, וי"ל כיון שכבר קבל קללת דוד ע"ע יחולו על ראש יואב וגו' וסבר דזה עונשו ולא יומת עוד ואמר או זה או זה לא אצא עד כי יתיר לי קללת דוד אביו:	Exodus 21:14
Paaneach Raza, Mishpatim 15	מכה אביו וגו', פירש"י בחנק. ובמקלל אביו פי' בסקילה ואיפכא מסתברא דמכה ראוי להיות חמור ממקלל, וי"ל דודאי מקלל חמור שכן ישנו לאחר מיתה ושלא בפניו משא"כ בהכאה:	Exodus 21:15
Paaneach Raza, Mishpatim 16	וגונב איש, תימה למה הפסיק בזה בין מכה למקלל. וי"ל דזה שגנב בא לידי כך שלא יכיר ברבות העתים את אביו ואמו, מהר"ר יעקב:	Exodus 21:16
Paaneach Raza, Mishpatim 17	ועי"ל דמכה וגונב מיתתן שוה משא"כ במקלל שבסקילה, לוי, וקשה יקדים גונב למכה דעדיין יהיו הם סמוכים ויסמכו גם מכה ומקלל, וי"ל דנקט לכל הני דינין בהדרגה דרך לא זו אף זו, דתחלה נקט רוצח ויזהירו דלא תיסק אדעתן להרוג כי גם הוא נהרג, ולא זו אלא אף זו מכה אביו הכאה בעלמא שיש בה חבורה ולא מיתה גם עליה נהרג, ולא עוד אלא אף גונב נפש ומכרו ולא מכהו כלל, ולא עוד אלא אף בדיבור בעלמא מצינו דנהרג דהיינו מקלל אביו, מצאתי:	NULL
Paaneach Raza, Mishpatim 18	ומקלל אביו, תימה איך יפסוק בזה מיתה, ימחול האב ויפטר דהא אמרינן האב שמחל על כבודו כבודו מחול, וי"ל דהרי מכה ומקלל אינם חייבים בלא התראה ועדים ואח"כ משקבלו התראה בעדים שוב אין יכולת למחול:	Exodus 21:17
Paaneach Raza, Mishpatim 19	ומקלל אביו וגו', פירש"י לרבות אשה שקללה, וקשה מהיכי תיתי דלא תתחייב הא הוקשה אשה לאיש לכל עונשין שבתורה, וי"ל דהו"א דכיון דאינה חייבת בכבוד דאין סיפוק בידה לעשות שהרי רשות אחרים עליה לכן גם בהכאה וקללה לא תחייב קמ"ל:	Exodus 21:17
Paaneach Raza, Mishpatim 20	ורפא ירפא, למדו מכאן שניתן רשות לרופא לרפאות. פי' אף בחלאים הבאים מעצמן דלא נימא רחמנא מחי ואיהו מסי (ומהכפל דרשינן לי'), ומהר"ר חיים פי' שניתן רשות לרפאותו מתחלה ולא חיישינן פן יהרגנו או יסכננו ע"י סם, וי"א שניתן רשות ליטול שכרו דסד"א שיעשה בחנם מטעם הנזכר, קמ"ל:	Exodus 21:19-20
Paaneach Raza, Mishpatim 21	וכי יכה איש את עבדו וגו', פירש"י שיצא מכלל מכה איש ומת להיות נדון בכלל יום או יומים וקשה דנימא לא ללמד על עצמו יצא אלא ללמד על הכלל כלו יצא לדון בדין יום או יומים. וי"ל דכי כספו הוא מועט, לישראל לאו כספו הוא:	NULL
Paaneach Raza, Mishpatim 22	נקום ינקם, פירש"י מיתת סייף דגמרינן מחרב נוקמת וגו', וקשה ל"ל למ"ד חנק חמור מהרג דהשתא על בן חורין החמור אינו אלא בסייף על עבד הקל לא כ"ש. וי"ל דהו"א מכיון דמקלינן בי' בדין יום או יומים נחמיר עלי' בהא קמ"ל נקום ינקם:	Exodus 21:20-21
Paaneach Raza, Mishpatim 23	ענוש יענש, פירש"י דמי ולדות וקשה אמאי דלמא נפל הוי, וי"ל דאזלינן בתר רובא כמו ברוצח דלא חיישינן שמא טריפה הרג או כיוצא בו:	Exodus 21:22
Paaneach Raza, Mishpatim 24	פצע תחת פצע, מכאן למדו לחייב על אונס כרצון, וקשה הא כתיב ולנערה לא תעשה דבר וגמרינן מיני' אונס רחמנא פטרי', וי"ל דלקטלא דוקא אונס פטור, אבל לממון לא, וקשה דבפרק המניח פטרינן אונס אפי' בממון בהאי דקנקנים, וי"ל דשאני התם היכא דאיהו קדים לכלים דהוי אונס גמור ובכזה פטרינן אפי' בממון שהרי אם קדמו כלים חייב, מהר"ר חיים:	Exodus 21:25
Paaneach Raza, Mishpatim 25	ונפל שמה שור או חמור, דדרשינן שור ולא אדם וכו', וקשה נימא איפכא שור ולא כלים חמור ולא אדם ונ"מ דלא אימעוט עבד ושפחה הדומין לחמור (וי"ל דודאי מסתבר תחלה למעט אדם ביותר דבעי טפי לעיוני ומיזל, ואי לא הוי אלא חד מיעוטא הוי ממעטינן אדם ומחייבינן בכלים, לכן מסתבר המיעוט הראשון באדם:	Exodus 21:37
Paaneach Raza, Mishpatim 26	ושל"ח א"ת בגימט' רג"ל השו"ר:	Exodus 22:3
Paaneach Raza, Mishpatim 27	כי יתן איש אל רעהו כסף או כלים לשמור, קיי"ל פרשה ראשונה בש"ח ולהכי נקט כסף או כלים שדרך לשמרן חנם, משא"כ בבהמות:	NULL
Paaneach Raza, Mishpatim 28	מיט"ב שדה"ו ומיט"ב כרמ"ו ישל"ם בגימט' שדה"ו וכרמ"ו ש"ל הניז"ק:	Exodus 22:4
Paaneach Raza, Mishpatim 29	ומצאה" קוצים" ונאכל" גדיש" ס"ת בהפך אותיות שלמ"ה, לרמוז והפכתי כסא ממלכות וגו', דהא האי קרא דרשינן לי' בבהמ"ק:	Exodus 22:5
Paaneach Raza, Mishpatim 30	כמהר הבתולות, כמ"ה ר' רמז למאתים לבתולה מן התורה:	Exodus 22:16-17
Paaneach Raza, Mishpatim 31	מכשפה לא תחיה ל"פ מיתתה כדי שלא תנצל במכשפות שיהרגוה באיזה מיתה שיכולין כדאשכחן בשמעון בן שטח שתלה פ' נשים באשקלן:	NULL
Paaneach Raza, Mishpatim 32	מכשפה לא תחי' וסמיך לי' כל שוכב עם בהמה, שהמכשפות עושין עצמן לבהמות כבמעשה אגג ושניהם בסקילה:	NULL
Paaneach Raza, Mishpatim 33	אם ענה תענה אותו, פירש"י הרי גיזם ולא פי' עונשו והא דכתיב אח"כ וחרה אפי וגו' זהו עונשו של אם צעוק יצעק שמצער אותו הרבה עד שיצעק אבל אם ענה תענה אותו פי' רק מעט בדברים, לזה גיזם ולא פי' עונשו, מהר"י:	Exodus 22:22
Paaneach Raza, Mishpatim 34	אם כסף תלוה פירש"י ר' ישמעאל אומר כל אם שבמקרא רשות חוץ מג' שהם חובה וזה אחת מהם, וקחשיב להו התם, שהשני הוא ואם מזבח אבנים וגו', והג' ואם תקריב מנחת בכורים, וקשה ליחשב נמי בהדייהו אם כופר יושת עליו דפירש"י בו שהוא חובה, וי"ל דלא דמי להנך דל"ש חובה שיהרוג את האדם ויבא לידי כופר, מהר"ר יעקב, אבל קשה ליחשב נמי ואם יהי' היובל דפירש"י שהוא חובה ואם בחקותי וכיוצא בהן וצ"ע:	Exodus 22:24
Paaneach Raza, Mishpatim 35	תלוה את עמי, פירש"י עמי ועכו"ם עמי קודם וקשה למה לי תיפוק לי' מדקדמה בנבילה נתינת הגר למכירה דעכו"ם כ"ש הלואה ולישראל, וי"ל דאצטריך דשמא נבילה דהוי דבר מועט שאני:	NULL
Paaneach Raza, Mishpatim 36	כי הוא כסותה, קרינן כסותו בוי"ו וכתיב כסותה בה"י לומר אף אם לבוש ה' כסותים, דהיינו טלית, כתונת, חגור, חלוק, ומכנסים, אינו חייב למכור ולקנות גרועה ממנו:	Exodus 22:26
Paaneach Raza, Mishpatim 37	ל"א תשימו"ן עלי"ו נש"ך, בגימט' אח"ד הלו"ה והמלו"ה אח"ד העדי"ם והסופ"ר ואח"ד הער"ב עוברי"ם בהלא"ו:	Exodus 23:1
Paaneach Raza, Mishpatim 38	ודמעך, לפי' הר"ר משה מפונטיז"א לשון לח כמו ותשקמו בדמעות שליש:	Exodus 23:1
Paaneach Raza, Mishpatim 39	לא תבשל גדי בחלב וגו' סמכו לראשית ביכורי אדמתך לומר שגם בביכורים א"צ להניח הפרי בקרקע עד שמתבשל הרבה ועד שיתבשל בו חלב רטיבה אלא תקריב בעוד שהיא לחה, ורמז לזה פי' דונש גדי לשון מגדים:	Exodus 23:1
Paaneach Raza, Mishpatim 40	בכורי אדמתך, בבבא בתרא אמרו למעוטי ח"ל שאינה חייבת בביכורים, וקשה ל"ל מהיכי תיתי לחייב הלא חובת קרקע הוא ובקדושין ילפינן מקרא דכל מצות התלוי' בארץ אינה נוהגת אלא בארץ, וי"ל דהו"א מדסמכת לבשר בחלב לנהוג בין בארץ בין בחו"ל כמוה ומה"ט נמי א"ש דמצריך קרא בספרי למדרש דבב"ח נוהג בין בארץ בין בחו"ל דהתם נמי תקשי לך ל"ל פשיטא דהרי חובת הגוף הוא אלא דהו"א איפכא דמדסמיך לבכורים אתקש להו ולא לנהוג אלא בארץ כמותם, צריכא, מהר"ר יעקב:	Exodus 23:19
Paaneach Raza, Mishpatim 41	לא תבשל גדי בחלב אמו, זש"ה לא תשיג גבול עולם, אל תקרי עולם אלא עלם כלומר גבולו של יונק שדים, שאלמנה מינקת צריכה להניק ב' שנים שלא יתבשל ויתבער העלם מחמת חלב אמו שלא תפרישנו מחלב, ולא תנשא עד ב' שנים לתינוק וכן תבש"ל בגימט' ב"פ שס"ה וב' יותר דהיינו נגד ב' ימים א' שנולד בו ואחד שמפרישין אותו בו:	Exodus 23:19
Paaneach Raza, Mishpatim 42	מלא"ך לפני"ך לשמר"ך בדר"ך, בגימט' במטטרו"ן המלא"ך ש"ר הפני"ם:	Exodus 23:20
Paaneach Raza, Mishpatim 43	לא תכרות להם ולאלהיהם ברית וקשה איך כרת שלמה ברית עם חירם, וי"ל דחירם גר ותושב הי' ממשפחת אבימלך אשר כבר כרת לו אברם ברית, מצאתי:	Exodus 23:32
Paaneach Raza, Mishpatim 44	(ואל תקשה על אברם גופי' דכבר בלא"ה קבל קצת עונש על כך כדאיתא לעיל פ' וירא אצל והאלהים נסה את אברהם וגו':	NULL
Paaneach Raza, Mishpatim 45	לא ישבו בארצך וגו', ותימה הא מיירי כאן בז' עממין וא"כ למה אצטריך האי קרא הא כבר כתיב בהו לא תחיה כל נשמה, וי"ל דסד"א ההוא דוקא במלחמה קמ"ל:	Exodus 23:33
Paaneach Raza, Mishpatim 46	וישם באגנות פירש"י להזות עליהם שנכנסו לברית במילה וטבילה והרצאת דמים, וקשה דבחולין ויבמות אמרו אבותינו מלו ולא טבלו, וי"ל דהתם אבותינו אברהם יצחק ויעקב קאמר, מוהר"ר יעקב:	Exodus 24:6
Paaneach Raza, Mishpatim 47	ויקח ספר הברית פי' רי"ח דהיינו עשרת הדברות כי עדיין הוצרך לפרשם עתה כי כבר נכתב לא תרצח ולא מפרש מי ומי ואיך וכל דקדוקי הדינין, וכן לא תנאף אם באלמנה או נשואה, בתולה וארוסה וחילוקיהן וכן כולם:	Exodus 24:7
Paaneach Raza, Mishpatim 48	כמעשה לבנת הספיר, בשעה ששיעבדו מצרים בישראל בלבנים ראתה אשה אחת מעוברת בבעלה שהוא עיף ויגע רצתה לסייע בעבודה קשה והפילה ע"ג לבינה אחת ונטלה הקב"ה ונתנה תחת רגליו להסתכל בה תמיד לזכור קושי צרתם ושעבודם, זהו כמעשה לבנת הספיר, והוא שנאמר השליך משמים ארץ תפארת ישראל ולא זכר הדום רגליו ביום אפו, שזהו אותה לבינה שהיתה תפארתם לזכור גלותם:	Exodus 24:10
Paaneach Raza, Mishpatim 49	לח"ת האבן בא"ת ב"ש הוא כס"א כי מתחת הכסא נלקחו:	NULL
Paaneach Raza, Mishpatim 50	כתבתי להוראתם, חסר כתיב לרמז שלעתיד ירבו מחלוקת ולא תהי' ההוראה שלימה ומלאה (ועם כל זה אל מקום א' הכל הולך כמו שאמרו אלו מטהרין ואלו וכו' אלו ואלו דברי אלהים חיים, לכן כתיב חסר, כי להורותם משמע לשון יחיד כאלו הכל הוראה אחת, שאלו הי' כתיב להורות הי' משמע לשון רבים כמו הוראותיהם שהם הוראות חלוקות ורבות בלתי מכוונות לנקודת האמת, לכן כתיב חסר שהוא כמו הוראתם שהם באחת ומכוונות כולם לדברי אלקים חיים):	Exodus 24:12-13
Paaneach Raza, Terumah 1	@שמות פרשת תרומה	NULL
Paaneach Raza, Terumah 2	ובעזר נותן לפתאים ערמה, נתחיל סדר ויקחו לי תרומה:	NULL
Paaneach Raza, Terumah 3	תרומה לילה ויקחו לי תרומה, רמז מאימתי קורין את שמע בערבין, משעה שהכהנים נכנסין לאכול בתרומתן והיינו בעת יציאת הכוכבים, וסימנו "שאו "מרום "עיניכם, ר"ת שמ"ע לומר שזמן ק"ש תולה בנשיאת עיניכם למרום לראות יציאת הכוכבים:	Exodus 25:3
Paaneach Raza, Terumah 4	ישראל" ויקחו" לי" ס"ת לו"י, כלומר לוי הוא לי, כנאמר והיו לי הלוים (ורמז דוקא בס"ת, מפני שמתחלה היתה העבודה לבכורים ולבסוף הוא שניתנה ללוים:	Exodus 25:3
Paaneach Raza, Terumah 5	תרומ"ה, אותיות תור"ה מ' לומר כי לא ניתנה התורה אלא לאוכלי מן שאכלוהו מ' שנה במדבר, כלומר לבטלים לה, שאינם עמוסים בשאר עסקים, או שכל העוסק בתורה שניתנה למ' יום הוא לי (ורמז זה במלת תרומה, כי התורה היא היא ההפרש האמתית שמובדלת מהשגת האדם שהיא שכלית לעצמה, והיא היא ההרמה וההתעלות הגמור הגמור כענין ומנחיאל במות וכתיב סלסלה ותרוממך):	Exodus 25:3
Paaneach Raza, Terumah 6	א"ל בנ"י ישרא"ל ויקח"ו ל"י תרומ"ה, בגימט' בנ"י ישרא"ל ה"ם תורמי"ן ול"א הגוים:	Exodus 25:3
Paaneach Raza, Terumah 7	ד"א ישראל ויקחו לי, מישראל יקחו הצריכים ולא מן העכו"ם, וקשה איך א"כ רצו לקנות אבנים לאפוד מדמא בן נתינא, וי"ל דאאבנים לא קאי, דמדלא כתיב ואבני שהם בוי"ו הרי הפסיק הענין:	Exodus 25:3
Paaneach Raza, Terumah 8	אשר ידבנו לבו דהא לא כתיב באלו כפר נפשם כמו בבקע לגלגולת, לכן יתנו מה שירצו:	Exodus 25:3
Paaneach Raza, Terumah 9	תקחו, תקח לא נאמר מכאן שאין גובין שום צדקה בפחות משנים:	Exodus 25:3
Paaneach Raza, Terumah 10	תקח"ו, בגימט' שני"ם קח"ו:	Exodus 25:3
Paaneach Raza, Terumah 11	זהב וכסף וגו', י"ג דברים כתובים כאן אשר כנגדן י"ג לבושי הוד שביחזקאל והם הם עדיים שפרקו מהם בחטא העגל, אנעלך תחש וגו' שע"ז נאמר הייתי ככלי אובד, שאבדו כלי יקר האלו, וכן אובד בגימט' י"ג וכנגדן נצטוו לכפר עליהם ולהחזירם, וביה"כ אמר הקב"ה למשה סלחתי כדברך והחזירם, לכן נתקנו ביה"כ י"ג מדות י"ג סליחות לזכור את אלו ואת זכות אבות של י"ג אותיות וזכות אמהות של י"ג אותיות וי"ג מדות התורה וזכות שמיחדים ה' אח"ד העולה י"ג וזכות מילה של י"ג בריתות:	Exodus 25:3-4
Paaneach Raza, Terumah 12	אבני שהם ואבני מלואים, פי' כי האבנים האחרים היו ממלאים רק המשבצות ואינם בולטים לחוץ, אבל אבני שהם שהיו ג"כ במשבצות כדכתיב מוסבות משבצות זהב, היו עוד בולטים הרבה לחוץ, לכן כתיב בי' מלואים, מהר"ר משה:	NULL
Paaneach Raza, Terumah 13	מבית ומחוץ תצפנו, מכאן שבשאר כלים דלא כתיב בהו הכי לא הי' הצפוי רק מצד א', כגון השלחן הי' הצפוי מעל גבו למעלה, חוץ כ"ד עגול כגון בדים ועמודים שהיו מצופים סביב:	Exodus 25:11
Paaneach Raza, Terumah 14	שנים כרובים נגד ה' אלהים, דהיינו מדה"ד והרחמים (כי התורה כלולה מהם שבכתב הוא רחמים ושבע"פ הוא מדה"ד), ושלמה הוסיף שנים כדכתיב ויעש שלמה שנים כרובים אחרים (והטעם מפני שכ"א כלולה משניהם) ומפני צדיק ורע לו רשע וטוב לו, צדיק וטוב לו רשע ורע לו, מצאתי:	Exodus 25:18
Paaneach Raza, Terumah 15	שנים כרובים, דרשינן שנים ולא ד' וקשה א"כ מה ראה שלמה להוסיף שנים אחרים, וי"ל דלענין משני קצות הכפורת דוקא נאמר כאן שנים ולא ד', אבל שלמה עשה הנך על הארון עצמו:	Exodus 25:18
Paaneach Raza, Terumah 16	ואל הארון תתן וגו', פירש"י ללמד שבעודו ארון לבד בלא כפרת תן העדות לתוכו, וקשה דגם זה נילף מקרא קמא שהרי כתיב ונתת אל הארון וגו' ואח"כ ועשית כפורת, ועוד ממ"ש בעשי' ויתן וגו' ואח"כ ויעש כפרת וגו' משם ידענו, וי"ל דחד אלוחות וחד אשברי לוחות שרמז לו כאן בייתור הזה ששברי הלוחות בארון יהיו מונחים, לוי:	Exodus 25:21
Paaneach Raza, Terumah 17	(ובודאי לעיל בסמוך שנזכר נתינת העדות לתוכו קודם עשיית הכפורת מסתבר שידבר בשברי לוחות שהם הראשונות ואמר שינתן תיכף לתוכו בעוד היותו ארון לבד ויפול בהם על נכון זה הלשון, ובכאן שנזכרה תחלה עשיית הכפרת עליו ואח"כ נתינת העדות לתוכו ידבר בלוחות שניות השלימות אשר בהם יתכן לשון זה באשר כבר קודם להם הי' הארון מכסה לראשונות קודם שנתנו אלו בו, ועוד אני אומר כי כפול של פסוק זה בא לומר שאף אם יוציאם לפעמים מהארון יחזירם שמה תמיד שלכן בתחלה כתיב לעיל בסמוך מתחלה ונתת והדר אל הארון כי אחר שתתנם שם הוא שנעשה ארון להם מאחר שכבר קודם זה לא היו בו מעולם, וכאן יאמר תחלה ואל הארון ואח"כ תתן כי יאמר שאל הארון שהוא כבר נעשה ארון להם במה שהונחו כבר בו פעם ראשון תתן עוד בו את העדות וגו' בכל פעם והתכלית בזה להרשותו להוציאם לפעמים לעת החפץ ושלא נאסרו בהסרה כבדי הארון, ועוד רמז לו באומר לו על הספר תורה שאתה עתיד לכתוב שתהא מונחת ג"כ בארון, ועיקר התכלית בזה לרמז צורך שתי ספרי תורות, א' שיוצאת למלחמה וכל אחת צריכה ארונה לנוח שמה, ועוד ירמוז על העתיד לדורות בלי הלוחות כלל לכל ס"ת וס"ת שתהא מונחת בארון ומזה נהגנו כן והדברים נכונים כולם):	NULL
Paaneach Raza, Terumah 18	בטבעות הארון יהיו הבדים וגו', וקשה הא כתיב במסעות ושמו בדיו וגו'. וי"ל דודאי לא הוסרו כדכתיב כאן רק שבחנייתן היו בטבעותיהם באופן שהיו יכולים לישא אנה ואנה מבלי הסרה לגמרי והיו נמשכין באופן שכל בליטתן היתה בצד א' והיו נראין בפרוכת כדדי אשה ובמסע הוצרכו לתקנם לתווכם בתווך ממש להתמצע לבלוט בצד זה כמו בצד זה כדי להשוות המשא ואז היו מהדקין אותן שלא יוכלו לזוז אנה ואנה ובחנייה הוסר ההידוק, מהר"ר משה:	Exodus 25:27
Paaneach Raza, Terumah 19	וקשותיו, פירש"י שלא יתעפשו, וקשה הא כתיב לחם חם ביום הלקחו ודרשו ז"ל שהי' תמיד כבראשונה וי"ל דודאי בדרך נס הי' כן אבל אין סומכין על הנס לכן צוה לעשות קשותיו, א"נ ר"ל רך:	Exodus 25:36
Paaneach Raza, Terumah 20	תיעשה המנורה אמרו ז"ל במנחות דג' דברים נתקשה בהם משה, מנורה, שרצים, החודש, עד שהראה לו הקב"ה באצבע, וי"א אף הלכות שחיטה, ותימה וליחשב נמי ההוא דאלו טריפות דאמר התם וזאת החיה מלמד שתפס הקב"ה כל מין ומין והראה למשה וא"ל זאת אכול וזאת לא תאכל, וי"ל דלא חשיב אלא הני דכתיב בהו זה, אבל קשה ליחשב נמי שקלים דכתיב בי' זה יתנו ואמרינן שהראה לו כמין מטבע של אש. וי"ל דהתם לא שייך נתקשה אלא דאין לו לידע מבלי שיראהו, ועי"ל דל"ח אלא הני דאית בהו קישוי ואומנות רב אף אם יראהו כמו מנורה ושרצים כי צפרדע דומה לצב ואינו מטמא וכיו"ב וכן החודש, אבל מטבע וחיות מכיון שרואהו הדבר נקל ואין בו אומנות:	Exodus 26:1-2
Paaneach Raza, Terumah 21	עצי שטים אמר הקב"ה יבאו עצי שטים ויכפרו על אותו מעשה של שטים:	NULL
Paaneach Raza, Terumah 22	על צדי המשכן מזה ומזה לכסותו, וקשה בפ' במה מדליקין אמרינן משכן קרוי משכן ואין קרשים קרוי משכן וכאן הרי הקרשים נקראים משכן (דאין לפרש שהיריעות התחתונות שהם של שש משזר הם נקראי' ג"כ משכן באמרו על צדי המשכן מזה ומזה דהא נאמר לכסותו וכנוי דלכסותו אמשכן קאי וא"כ ע"כ שיכסה האמות המגולות בקרשים קאמר כן, וא"כ על הקרשים קאי נמי צדי המשכן):	Exodus 26:12-13
Paaneach Raza, Terumah 23	ועמודיו עשרים ואדניהם עשרים נחושת וגו'. וקשה למה לא פירש בעמודי החצר ממה יהיו, וכן למה לא פי' כאן צפוי הכסף של ראשי העמודים כבפרשת ויקהל ופקודי, מהר"ר יעקב:	Exodus 27:10
Paaneach Raza, Terumah 24	עמודיו עשרים, פירש"י ה' אמות בין עמוד לעמוד, פי' עם עובי העמוד שהוא ג' טפחים:	Exodus 27:11
Paaneach Raza, Tetzaveh 1	@שמות פרשת תצוה	NULL
Paaneach Raza, Tetzaveh 2	ובעזרת כאילות רגלי משוה, נתחיל סדר ואתה תצוה:	NULL
Paaneach Raza, Tetzaveh 3	ואתה תצו"ה בגימט' נשי"ם צו"ה, מכאן חיוב הדלקה לנשים:	Exodus 27:20
Paaneach Raza, Tetzaveh 4	ורוחב חמשים בחמשים וסמיך לי' אתה תצוה וגו' להעלות נר וגו' רמז לגובה חמשים אמה למנורות בית השואבה כדאיתא בסוכה:	Exodus 27:20
Paaneach Raza, Tetzaveh 5	ואתה תצוה, רמז לעשות נחש נחושת, כי ה' פעמים נחש בבראשית וכנגדן ה' פעמים נחושת לעיל בפרשה ועלה קאמר ואתה תצוה, וכן מזה בידך חסר ה' לרמוז על היפוך מטה לנחש הוזכר ה' פעמים, תימה למה לא נזכר משה בכל אלה הפרשיות, וי"ל מכיון שאליו היתה ראוי' הכהונה וניטלה הימנו מאמרו שלח נא ביד תשלח ונתנה לאהרן לכן לא נזכר שמו על כל השייך לכהן:	Exodus 27:20
Paaneach Raza, Tetzaveh 6	להעלות נר, חסר ו' כתיב לומר כי ו' נרות שאין עולין ונוטין כלפי מעלה רק השביעי האמצעי לבד והנך נוטין מול פניו:	Exodus 27:20-21
Paaneach Raza, Tetzaveh 7	יערך אותו אהרן ובניו, וקשה למה נזכר אהרן לבדו בסוף אמור, וי"ל שמתחלה היו בניו מדליקין וכשמתו נדב ואביהוא לא הניח עוד בניו לילך שמה יחידים זולתו, מהר"ר משה:	Exodus 27:21
Paaneach Raza, Tetzaveh 8	מערב עד בוקר, פירש"י תן לה מדתה וכו', וקשה והא כתיב מערב עד בוקר כלומר שתהא דולקת מערב עד בוקר ואיך א"כ תהא המדה שוה ומכוונת ללילות ארוכות וקצרות, וי"ל דלפי הלילות עשו הפתילות דקות או גסות באופן שדלקה תמיד בשוה מערב עד בוקר מצומצם, פרי עץ חיים:	Exodus 29:41
Paaneach Raza, Tetzaveh 9	ואתה הקרב אליך וגו', וקשה מה צריך נדב ואביהוא אלעזר ואיתמר בשמותיהם הלא כבר נאמר בניו סתם, וי"ל דלמעוטי פנחס אתא ואפי' למ"ד כבר נתכהן פנחס בא לומר שעיקר עבודה באלו:	NULL
Paaneach Raza, Tetzaveh 10	מצנפת, הך של כ"ג קרוי מצנפת מפני שלא הי' יכול להולמה מפני הציץ אלא שצנפה מלמעלה צניפה בעלמא ושל כהן הדיוט קרוי מגבעות מלשון גביעים שהי' הולמו לגמרי ונתקבל הראש תוך בית קבולם ואף דאיהו נמי לא הי' יכול להולמו לגמרי מלפניו מפני התפילין מ"מ מאחוריו הולמתו שפיר, ואלו בכהן גדול אף מאחוריו לא, מפני פתיל תכלת של הציץ:	NULL
Paaneach Raza, Tetzaveh 11	פתוחי חותם צ"ע שבבית שני לא הי' שמיר במה נחקקו:	NULL
Paaneach Raza, Tetzaveh 12	חש"ן המשפ"ט, בגימט' דמכפ"ר הרהו"ר ל"ב:	NULL
Paaneach Raza, Tetzaveh 13	א"ת האורי"ם וא"ת התומי"ם בגימט' ש"ם ב"ן שבעי"ם ושתי"ם אורים ותומים גימט' הד"א או"ר ישרא"ל:	NULL
Paaneach Raza, Tetzaveh 14	ופעמוני זהב, פירש"י זגין עם ענבלין שבתוכן, וקשה דפעמון מלשון ותפעם הוא שפועם ומקשקש מבפנים לבד, ואונקלוס תירגם זגין דמשמע החיצון לבד שהרי מחרצן ועד זג תירגם מפורצנין ועד עיצורין דהיינו שמתרגם על זג שהוא הוא העוצר את המשקה והגרעינין, וכדמשמע בנזיר, מהר"ר יעקב:	NULL
Paaneach Raza, Tetzaveh 15	(ונ"ל דודאי פעמון הוא לשון ותפעם רוחו, אבל מ"מ ביותר יפול השם הזה על החיצון הסובב דהוא הזג, וזה לו שם עצם כי בו נודע הפעימה שמשמיע קולו מאריך בו, כענין קולו כפעמון, שמכח שהעינבל מכה ופועם עליו הוא משמיע קול ומאריכו, משא"כ בעינבל עצמו, אבל מ"מ גם על שם זה לא יקרא פעמון כי אם בהיות העינבל עמו, ומטעם זה יפה דיבר רש"י שכתב זגין עם עינבלין שבתוכן שבזולת זה גם החיצון לא יקרא פעמון ולא נודע בו פעימה א"כ אם נאמר פעמון שיפול על השמעת קול של החיצון, ע"כ יכלול שניהם, והתרגום שתירגם ללשונו, תירגם זג, בעבור שבלשונו הוא שם מיוחד בעצם לחיצון לבדו, כנודע מקרא דמחרצן ועד זג, והרי עיקר שם פעמון ג"כ על החיצון, רק שכשקוראין אותו כן בהכרח נכלל גם העינבל כנז', וק"ל):	NULL
Paaneach Raza, Tetzaveh 16	ובצאתו ולא ימות, פירש"י הא אם יכנס מחוסר אחד מהבגדים וכו', וקשה למה לי ולא ימות הא ידעינן לי' מדרשינן אין בגדיהם עליהם אין כהונתם עליהם וממילא הוו זרים לעבודה וזר ששימש במיתה, מהר"ר יעקב:	NULL
Paaneach Raza, Tetzaveh 17	וי"ל דההוא כתיב בארבע בגדים אשר כ"ג והדיוט שוין בם, אבל בהני ד' יתירים דכ"ג ה"א למצוה בעלמא נינהו ולא מיתה להכי אצטריך (ולי נראה דל"ק כלל דהכא לכניסה בעלמא בלי שימוש ידבר ויקבע בו מיתה:	NULL
Paaneach Raza, Tetzaveh 18	צי"ץ, בגימט' ק"ץ כענין שכתוב ועליו יציץ נזרו:	NULL
Paaneach Raza, Tetzaveh 19	וחגרת אותם אבנט אהרן ובניו, מהאי קרא ילפינן בפ"ב דזבחים בזמן שבגדיהם עליהם וכו' וזר ששימש במיתה וכו', וקשה להר"ר יעקב למה לי תיפוק לי' דכתיב בהדיא מיתה מויהיו על אהרן ועל בניו בגשתם אל המזבח ולא ימותו, וי"ל אי מההוא הו"א אם חסרים כולם כמשמעות אין בגדיהם עליהם וכמשמעות לשון רבים דויהיו על אהרן וגו' דמשמע אם לא יהיו וכו' לכן כתיב מיותר אהרן ובניו בחד מינייהו דהיינו באבנט לבד לומר שאף אם חסר א' מהם, מצאתי:	NULL
Paaneach Raza, Tetzaveh 20	והיה" המזבח" קדש" קדשים", ס"ת משח"ה, כי היו מושחין אותו כמין כ' יונית, וכן המלכים לומר כי לה' המלוכה (ולכן כל הרמז בס"ת ומהופך למפרע כי ד"ז יהי' לעתיד ולבסוף באחרית הימים כדכתיב ועלו מושיעים וגו' והיתה לה' המלוכה דהיינו כשאז יהפך אל עמים וגו' לכן הרמז בהפוך ובסוף):	NULL
Paaneach Raza, Tetzaveh 21	תשרף באש מחוץ למחנה, פירש"י לא מצינו חטאת חיצונה נשרפת אלא זו וקשה דבפ' בהעלותך כתיב דפר של לוים נשרף והרי הוא חטאת חיצונה, וי"ל דפנימית היתה גם היא, מכיון שהלוים הביאוהו לחטא ע"ז כפירש"י לקמן בבהעלותך:	NULL
Paaneach Raza, Tetzaveh 22	ולקחת את האיל השני וגו', כאן בציווי כתיב בי' הזאה תחלה על אהרן ובניו ובגדיהם אף משמן המשחה והדם, ואח"כ הקטר החלבים, ותימה דבפ' צו בעשייתו כתיב ההקטר תחלה קודם הזאת דם ושמן המשחה, ואיך יתכן ששינה משה ועשה בהיפך, מרבי:	NULL
Paaneach Raza, Tetzaveh 23	(וי"ל דודאי דעת הקב"ה היתה גם בציווי שתהי' הזאת דם ושמן המשחה באחרונה, ועמד משה אל אמתת דבריו ודעתו מדכתיב בהזאה וקדש הוא ובגדיו וגו' בלשון עבר, שרצה שבהזאה זאת כבר תהי' קדושתן נגמרת ונשלמה, שיהי' הכל כבר נעשה, וא"כ ע"כ צריך להיות ההקטר מקודם דזולת זה לא הי' עדיין קרבנם וקדושתן שלמה כבדיני כל הקרבנות כולם ופשוט הוא, ואעפ"כ הוכרח ציווי ההזאה עליהם להיות תיכף אחר וזרקת את הדם על המזבח סביב, כדי ללמדו להועיל שזריקה זו בדם על המזבח צריכה להיות באופן שלא ייבש וישקע בכדי שאחר ההקטר יוכל ליקח ממנו להזאה, ולכן חזר הכתוב והבין את שמועתו במאמר וקדש הוא ובגדיו וגו' כנז' שלא יובן שבאמת תהי' ההזאה אחר הזריקה על המזבח רק שבאמת יהי' ההקטר תחלה כנז', ולכן לקמן בעשיה כתיב ג"כ באחרונה ויקדש את אהרן ואת בגדיו וגו' ובלשון הוה שמאחר שגם ההקטר כבר נעשה נתהות עתה בהזאה זאת כל קדושתם כולה ונגמרה בשלימות):	NULL
Paaneach Raza, Tetzaveh 24	ונסך רביעית ההין יין פירש"י לספלים לאפוקי ויין לנסך רביעית ההין דבפ' שלח שהוא למשה להקרבה, וכדכתיב והקריב המקריב וגו', מהר"ר יעקב:	NULL
Paaneach Raza, Tetzaveh 25	(והיינו דלא כדעת רש"י שם וצ"ע במס' סוכה):	NULL
Paaneach Raza, Tetzaveh 26	פתח אהל מועד כנגד הפתח, ובשעה שהוא פתוח מהר"ר יעקב:	Exodus 29:42
Paaneach Raza, Ki Tisa 1	@שמות פרשת כי תשא	NULL
Paaneach Raza, Ki Tisa 2	ובעזר יושב על כסא רם ונשא, נתחיל סדר כי תשא:	NULL
Paaneach Raza, Ki Tisa 3	כי תשא את ראש וגו' ונתנו איש כפר נפשו סמכו לחטאת יום הכפורים, מכאן שפוסקין צדקה וכפר נפש ביום הכפורים אשר אז נמנה כל ראש ועוברין לפניו כבני מרון:	Exodus 30:12
Paaneach Raza, Ki Tisa 4	כי תשא, פירש"י שאל תמנם לגלגולת אלא יתנו וכו' וקשה הא כתיב ויפקדם בטלאים ויפקדם בבזק, וכן לקמן פירש"י שנמנו פעם שני' ולא אתפרש שנתנו שום דבר וי"ל דדוקא כאן לכפר על מעשה העגל נתנו, וזה איש כפר נפשו שעתה משום כפרת נפש יתנו:	Exodus 30:12
Paaneach Raza, Ki Tisa 5	כל העובר על הפקודים י"מ כל העובר במנין, ושבט לוי שלא נמנו לא נתנו, וי"מ כל העובר בים ואף שבט לוי נתנו ורז"ל דרשו זה יתנו כל י"ב שבטים כמנין ז"ה יתנו. מהר"ר משה:	Exodus 30:14
Paaneach Raza, Ki Tisa 6	מב"ן עשרי"ם שנ"ה ומעל"ה בגימט' מב"ן עשרי"ם לעונשי"ם שאין ב"ד של מעלה מענישים לפחות מבן עשרים עשרי"ם בגימט' עשי"ר וד"ל, וקנמ"ן בש"ם בגימט' בירושל"ם שפסול חוץ לירושלים, וב' תגין למעלה על הבי"ת נגד ב' ירושלים שלמעלה ושלמטה:	Exodus 30:14
Paaneach Raza, Ki Tisa 7	קח לך סמים וגו' ואם נתן בה דבש פסולה, וא"ת תיפוק לי' משום רבוי סממנים, וי"ל דברבוי סממנים אין בו מיתה, דהא דמרבה במעלה עשן חייב היינו משום דאינו צורך גבוה דא"צ רק כל שהוא:	Exodus 30:34
Paaneach Raza, Ki Tisa 8	את שבתותי תשמורו אמרו דב' מלאכים מלווים לו לאדם בע"ש אחד טוב וא' רע מורי אומר שהם צדק ומאדים דבין השמשות זה נכנס וזה יוצא:	Exodus 31:13
Paaneach Raza, Ki Tisa 9	"אות "הוא "לעולם "כי, ר"ת אהל"ך, כענין וידעת כי שלום אהלך שצריך שלום בית:	Exodus 31:17
Paaneach Raza, Ki Tisa 10	את השמים וגו', וקשה למה לא כתיב את הים וגו' כבעשרת הדברו', וי"ל דהכא כתיב אות הוא ואין אות ניכר במים, מהר"ר יעקב:	Exodus 31:17
Paaneach Raza, Ki Tisa 11	וביום" השביעי" שבת" וינפש" ס"ת הם שתי"ם למפרע שיש לו שתי נפשות, (ומה שבא הרמז בס"ת ובהפוך לומר כי בסוף השבת נהפך הוא שחזרה נפש יתירה ממנו וכדי ליישבו על נכון על מלת וינפש שהוא לענין זה דרשו וי נפש כלומר וי על נפש שאזלת מיני'), וינפ"ש בגימט' אל"ו שבגיהנ"ם (שזהו שבת וינפש ששובת מהם בו ביום וי של נפש):	Exodus 31:17
Paaneach Raza, Ki Tisa 12	השביע"י שב"ת וינפ"ש בגימטריא כשהו"א שב"ת אב"ד ל"ו ל"ב ונפ"ש (וביום השביע"י שב"ת וינפ"ש בגימט' בשית"א אלפ"י שנ"י הוי"א עלמ"א ובח"ד הו"א חרי"ב):	Exodus 31:17-18
Paaneach Raza, Ki Tisa 13	וית"ן א"ל בגימט' ז"ה התלמו"ד, שני לוחות שתים דוקא כנגד ב' תורות ב' עולמות שמים וארץ:	NULL
Paaneach Raza, Ki Tisa 14	לחות אבן, שרוב העונשים סקילת אבנים:	Exodus 31:18
Paaneach Raza, Ki Tisa 15	כי בשש משה בפ"ק דיומא קאמר דטעו במה שחשבו גם היום שעלה בו מן המנין ובאמת אינו מן המנין לפי שאין לילה עמו, וקשה למה לא הגיד להם אהרן טעותם, מהר"ר יעקב:	NULL
Paaneach Raza, Ki Tisa 16	(ולא קשיא כלל דודאי אמר להם ולא שמעו לו ועוד אף אם לא הגיד להם היינו מאימת הריגת חור שהיתה עליו):	Exodus 32:1-2
Paaneach Raza, Ki Tisa 17	אלה אלהיך וקשה וכי שוטים היו לומר כן, אלא בשעה שעלו מן הים הי' טיט ורפש בשפתו מפני שכיון שלא הי' לים מהלכו שפך מימיו בשפתו, או מפני שהשפה היתה גבוה ולא היו יכולין להלוך או לעלות וראו בטיט הרגש כפות רגלי עגל מהמלאכים שהיו שם לכן עתה כשראו עגל זה חי אמרו אלה אלהיך אשר העלוך, מדודי ר' אשר הלוי:	Exodus 32:4
Paaneach Raza, Ki Tisa 18	למה ה' יחרה אפך וגו', וקשה וכי לא עלובה כלה שזינתה בתוך חופתה ומה התנצל בעדם, וי"ל שאמר הלא הערב רב החטיאם ולמה א"כ יחרה אפך בעמך צאנך מה עשו ועוד שמכיון שאין בו ממשות אין לך לקנאות בו כי אין גבור מתקנא וכו', וזהו והנחם כלומר התבונן בדבר:	Exodus 32:11
Paaneach Raza, Ki Tisa 19	שוב מחרון אפך כשאומרים זה בבהכ"נ מקדימין ה' אלהי ישראל מפני שעולה תרי"ג בגימט' וכשמזכירין תרי"ג השי"ת משרה שכינתו ושב מחרון אפו:	Exodus 32:12
Paaneach Raza, Ki Tisa 20	זכור לאברהם וגו' במס' שבת אמרו דעשר רננות התפלל ולא נענה עד שהזכיר זכות אבות וזהו ושבח אני את המתים, וקשה הא אמרינן כל התולה עצמו באחרים תולין אותו בעצמו שנענה בזכות עצמו, מהר"ר יעקב:	Exodus 32:13
Paaneach Raza, Ki Tisa 21	(ואין מקום לקושיא זו דודאי זכות אבות שאני):	NULL
Paaneach Raza, Ki Tisa 22	וישבר אותם יותר הי"ל להניחם למעלה מלשברם כדי שכשישובו יחזור ויטלם, אלא שאמר משה אם אניחם קיימים הלא כתיב בהם לא תעשה לך פסל וכתיב עדות ה' נאמנה והי"ל ית' ליקח נקמתו מהם מיד, לכן ראה יותר לשברם:	Exodus 32:19
Paaneach Raza, Ki Tisa 23	וישבר אותם פירש"י אמר משה ומה פסח שהוא א' מכל מצות וכו' וכל בן נכר לא יאכל בו וכו', וקשה לר"י דמה ק"ו הוא זה דשאני פסח שהוא קדשים אבל כאן אדרבא הי"ל ללמד תורה ולהחזירם למוטב ולתשובה, ותו התינח מצוה אחת או שתים אבל לבטל כל התורה על כך מנ"ל, ותירץ דלפי המדרש שפרחו האותיות נפלו הלוחות מרוב כובדן ונשתברו מעצמן, וקשה א"כ מה הי"ל למשה לעשות ומה א"ל הקב"ה אשר שברת, וי"ל שסייע הוא בשבירתן בידים לאחר שנפלו וזהו וישליכם וגו' וישבר אותם, וזהו אשר שברת יישר ששברת, לוי:	NULL
Paaneach Raza, Ki Tisa 24	ובזה מתיישב ג"כ מה שאמרו בברכות הזהרו בזקן ששכח תלמודו כי לוחות ושברי לוחות בארון היו מונחים, דקשה שאני שברי לוחות שעדיין הדברות היו חרותות בהם לאפוקי זה אין בו עוד תורה אלא שגם בלוחות האותיות כבר פרחו מהם, מהר"ר אהרן:	NULL
Paaneach Raza, Ki Tisa 25	ויאספו אליו כל בני לוי וקשה וכי לא הי' בכל ישראל עוד מי לה' אל משה ועוד איך נלחמו בני לוי נגד כל ישראל, וי"ל שבני לוי התחילו ואח"כ כל הברכים אשר לא כרעו לבעל:	Exodus 32:26
Paaneach Raza, Ki Tisa 26	כה אמר ה' וגו' הרגו, וקשה היכן אמר ה' וי"ל דכתיב זובח לאלהים יחרם:	NULL
Paaneach Raza, Ki Tisa 27	ומשה יקח את האהל פי' הקירון פנים מלשון בהלו נרו והוא שלמדו מכאן בפ' רע"ק שנטל משה ק"כ רבוא כתרים שנתפרקו מהם, מרבי:	NULL
Paaneach Raza, Ki Tisa 28	הורד עדיך משום אבילות א"נ משום דם הברית שנזרק על בגדיהם בפ' משפטים שהי' מעיד שקבלו התורה:	Exodus 33:5
Paaneach Raza, Ki Tisa 29	הורד עדיך, וקשה והא כתיב ולא שתו איש עדיו עליו וי"ל לא שתו פי' הסירו, רבי בשם ר' יוסף קרא:	Exodus 33:5
Paaneach Raza, Ki Tisa 30	ד"א לא שתו עדים אל לבם להסירם רק איש עדיו עליו, וי"מ כי ב' כתרים הי"ל הא' הורידו והא' נשאר עליהם עד ויתנצלו עדים מהר חורב:	Exodus 34:28
Paaneach Raza, Ki Tisa 31	ד"א ולא שתו, זה עדיי המלבושים והורד עדיך אלו הכתרים:	Exodus 34:28
Paaneach Raza, Ki Tisa 32	ויאמר פני ילכו, וקשה א"כ מה השיב משה אם אין פניך הולכים הלא כבר אמר ה' פני ילכו וי"ל שהקב"ה אמר אדרבא פני ילכו, פי' חרון אפי והשיב משה אם אין חרונך הולכים ועוברים אל תעלנו מזה:	NULL
Paaneach Raza, Ki Tisa 33	הראני נא את כבודך, וקשה הא שבחו הכתוב בויסתר משה את פניו (וכבר כתוב לעיל בשמות מזה ע"ש) וי"ל דלא בקש כאן לראות רק שנתכוין לברית על שילכו פניו ושיהיו מובדלים משאר אומות:	NULL
Paaneach Raza, Ki Tisa 34	פני ילכו וגו', פירשב"ם שהקב"ה אמר תחלה הנה מלאכי ילך לפניך, והתפלל משה הודיעני נא וגו' שילך בעצמו וכבודו והשיב הקב"ה פני ילכו והניחותי לך, כלומר אעשה כן עד לארץ ישראל ע"ד עד אשר יניח לאחיכם וגו', ומשה אמר אם אין פניך הולכים תמיד אל תעלנו מזה ונאות לו הקב"ה ואמר גם את הדבר הזה וגו':	NULL
Paaneach Raza, Ki Tisa 35	אשר שברת, וקשה למה לא זכו לוחות ראשונות להתקיים, וי"ל משום שנתנו בקולות ועי"ל משום שלא נכתבו מן הכתב אע"פ דלמעלה לא שייך, מהר"ר אליעזר:	NULL
Paaneach Raza, Ki Tisa 36	נוצר חסד לאלפים, וקשה דבואתחנן כתיב לאלף דור, ואומר רבינו שמואל דהאי לאלפים לאלף דור הוא, דשייך שפיר לומר בי' לאלפים כמו שילשים על דור שלישי ורבעים על דור רביעי, ג"ן:	NULL
Paaneach Raza, Ki Tisa 37	וימהר משה ויקד וגו' על שמרובה מדה טובה ממדת פורעניות חמש מאות ד"א על שאין נפרעים מהחוטא לבד ונשאו בניו ובני בניו אתו, ד"א מכיון שהי' עובר על פניו מיהר לדבר עוד:	NULL
Paaneach Raza, Ki Tisa 38	כי עם קשה עורף הוא פי' כאשר אמרת אתה לעיל עם קשה וגו' ושלא תלך עמנו מטעם זה, מזה הטעם עצמו ראוי שתלך עמנו ותסלח כי המלאך לא ישא לפשעיהם, ג"ן:	NULL
Paaneach Raza, Ki Tisa 39	ד"א כי עם קשה עורף הוא לסבול גם גזירות קשות ומחזיקים ביראתך בשביל כבודך לכן נאה לך לסלוח:	NULL
Paaneach Raza, Ki Tisa 40	ויתן על פניו מסוה מכאן כשבאין מן התיבה ומקריאת התורה שמכסין את הפנים, פי' קרן עור פניו מזיו שכינה ולכך סמך לזה בפ' ויקהל ענין שבת לומר שאינו דומה קירון פניו של אדם בשבת לחול:	Exodus 34:33-34
Paaneach Raza, Ki Tisa 41	כי קרן וגו', באו תגין על הרי"ש לומר שקירון זה זכה מכתרים שעל הראש של ק"ך רבוא כנזכר לעיל, ד"א מכתר תורה, שכשהי' כותב הי' מקנח דיו של אש על פניו, קרנים "מידו "לו "ושם "חביון עוזו ר"ת מלו"ח שהקרנים באו לו מלוחות של עוז אשר ה' לעמו יתן, (ואני אומר כי הרמז בתגי הרי"ש הזאת הוא ע"מ שדרש במדרש ב"ר על פסוק בראשית שנברא העולם בזכות משה שנאמר וירא ראשית לו, וידוע כי בריאת העולם היתה באות ב' שמאלפא ביתא החקוק בעט שלהבת על כתר נורא ואיום של הקב"ה כדאיתא באותיות דרע"ק, גם דרשו בראשית, בשביל ראשית דרכו שבזכות התורה העולם נברא והיא עצמה נקראת תורת משה, והנה איך לא יקרן ויאיר פני משה בפרט עתה בקבלו הלוחות והתורה לזכיות נוראים ונפלאים כאלה, לכן נרמז כ"ז במלת כי קרן וגו' בתגי הרי"ש האלה לומר שזהו ההארה והקירון, דהיינו שראשית העולם הנברא מתג וכתר ראש וראשון ית' בשביל ראשית דרכו כ"ז ניתן למשה אשר ראה ראשית לו לתג וכתר תורה ומלוכה, לכן בא תגין ברי"ש ובמלת קרן דוקא):	Exodus 34:35
Paaneach Raza, Vayakhel 1	@שמות פרשת ויקהל	NULL
Paaneach Raza, Vayakhel 2	ובעזר שיכן באדם אהל, נתחיל סדר ויקהל:	NULL
Paaneach Raza, Vayakhel 3	ויקהל משה פירש"י למחרת יום כפורים, ותימה דהא לעיל בוישב משה לשפוט פי' ג"כ למחרת יום כפורים ואיך יתכן דכ"ז ביום א', וי"ל דיכול להיות דעד זמן אכילה עד חצות ישב לשפוט ואח"כ צוה על הבערה והמשכן בו ביום, מהר"ר משה, עוד פירש"י דהקדים אזהרת שבת לציווי משכן וכו', ותימה דשבת הוי עשה דאת שבתותי תשמורו ול"ת דכל מלאכה לא תעשו ואלו מלאכת המשכן אינו אלא עשה דאין עשה דוחה ל"ת ועשה (וי"ל דמהכא הוא דילפינן זה):	Exodus 35:1
Paaneach Raza, Vayakhel 4	אלה הדברים אשר צוה וגו', רמז לארבעים אבות מלאכות חסר א', כי אלה גימט' ל"ו, דברים מיעוט רוב שנים הרי ל"ח, דברים הדברים לרבות עוד אחת הרי ל"ט, ועוד כתיב לעשות אותם לעש"ת אותיות ל' תשע (והוא כמנין ט"ל שהוא מספר אותיות שניות של שם המיוחד שהם כוז"ו, והרמז שיש לייחד היחוד הגמור ית' שחידש מלאכת העולם כרצונו המוחלט ואין שני שיאמר לו מה תעשה ושישבתו מכל השניות להרחיקן לגמרי, לכן באה השביתה במלאכות במספר הזה, ועוד שאל ידאגו שבשביל השביתה לא יהי' לכם מה לאכול כי הוא ית' יתן להם בשכר זה טל"י אורות וגשמי ברכה יהיו בעתם, במדה כנגד מדה, וכאשר אירע להם במן, ושלזה הטעם בא להם המן בלחם משנה, והוא הטעם שירד דוקא בירידת הטל כדכתיב ותעל שכבת הטל וגו' במדה נכונה):	Exodus 35:1
Paaneach Raza, Vayakhel 5	כל העושה וגו' לא תבערו וגו' פליגי בה אי לחלק יצאת אי ללאו יצאת, וקשה אמאי לא נדרשי' בכלל ופרט ואין בכלל אלא מה שבפרט הבערה אין מדה אחרינא לא, וי"ל דאמרינן במועד קטן כ"מ שאתה מוצא כלל בעשה ופרט בל"ת לא דיינינן לי' בכלל ופרט, והיינו כי האי דהכא ופי' לא דנין לי' במדה זו אבל דנין לי' בדבר שהי' בכלל ויצא מן הכלל, חיים:	NULL
Paaneach Raza, Vayakhel 6	וא"ת למה לא דרשינן נמי לא תוציאו בדבר שיצא מן הכלל כמו בהבערה, וי"ל דאינה חשובה מלאכה לומר דבכלל העושה מלאכה היתה, ד"א למה הזהיר על ההבערה יותר מפני שאינה ניכרת ומפורסמת כ"כ לכן צריך אזהרה טפי, גם מפני שהי' צריכה תדיר, מהר"ר משה:	NULL
Paaneach Raza, Vayakhel 7	ויבאו האנשים על הנשים פי' ליקח מהם תכשיטיהן אבל ברצון הנשים הי' ואדרבא בזריזות בשמחה ובטוב לבב נתנום, משא"כ במעשה העגל דכתיב ויתפרקו בתי"ו ההתפעל דמשמע בע"כ ולכן זכו דראש חודש הוי יו"ט להם, מהר"ר משה:	NULL
Paaneach Raza, Vayakhel 8	וכל אשה חכמת לב בידיה טוו פי' לא בלבד שהיו חכמות לב לדעת חכמה במלאכות וללמדה אלא אף שהיו יודעות לאמן ידיהם לכך ולעשותה בעצמן, וקשה טוו הוא לשון רבות טוה או טותה מבע"ל דהא כתיב וכל אשה וגו' בלשון יחידה (וי"ל דנקט טוו לכלול גם שאין חכמת לב, דמהנך ראו וכן עשו אף אשר לא חכמו בלבותם בעצמן לעשות כן והוי כאלו אמר שכל אשה חכמת לב זכתה וזיכתה):	Exodus 35:5
Paaneach Raza, Vayakhel 9	קרא ה' בשם בצלאל פי' שבשמו נרמזת חכמתו והוא שאמר לו משה בצל אל היית, שכוון בצלאל אף [שלא] אמר לו משה כדפירש"י לקמן, ג"ן:	NULL
Paaneach Raza, Vayakhel 10	וא"ת מ"ש דגבי בצלאל יחסו עד אבי אביו ולא כן גבי אהליאב, וי"ל לפי שחור נהרג במעשה העגל והמשכן בא לכפר על אותו מעשה של העגל שהראה להם הקב"ה שנתרצה לכן נעשה ג"כ ע"י בן בנו של חור עצמו וזה בא הכתוב להודיענו כאן בכך, מצאתי:	Exodus 35:17-18
Paaneach Raza, Vayakhel 11	בחכמ"ה עולה תרי"ג במילוי אותיות כזה חי"ת כ"ף מ"ם ה"י, וכן נחל"ה נו"ן חי"ת למ"ד ה"י, והוא שכתוב טובה חכמה עם נחלה, מהר"ר יהודה:	NULL
Paaneach Raza, Vayakhel 12	ולחשוב מחשבות דרשינן מיני' מלאכת מחשבת דוקא אסרה תורה, ותימה א"כ ל"ל אשר חטא בה דממעטינן מיני' פרט למתעסק תיפוק לי' דאינה מלאכת מחשבת, מרבי:	Exodus 35:32
Paaneach Raza, Vayakhel 13	(וי"ל דלענין חיוב נפקא מלחשוב מחשבות, ומאשר חטא נפקא דמתעסק אין בו חטא כלל ולא לבד שאינו חייב, ואשר חטא לחודי' נמי הוי מוקמינן לה במסתבר דחיוב רק לפוטרו מחיובא:	NULL
Paaneach Raza, Vayakhel 14	ויעש את שמן המשחה קודש ואת קטרת הסמים טהור, וא"ת למה שינה ונקט בזה דוקא קודש ובזה טהור, וי"ל דשמן המשחה הוא מקדש אחרים במשחם בו כדכתיב לעיל בכלים ובאהרן ובניו ובגדיהם, וקדשת אותם, אבל הקטרת שאינו כן כתיב בי' טהור על שחיבת הקדש מכשרת לקבל טומאה ולהצריך טהרה ובקטרת נמי הכי הוא:	Exodus 37:29
Paaneach Raza, Vayakhel 15	במראות הצובאות, הכיור הי' נתון בין אהל מועד ומזבח, משוך מעט כלפי צפון כדי שיראוהו הנשים ויזכרו תמיד שמשקין משם הסוטה כדכתיב מים קדושים בכלי חרס ומתרגמינן מי כיור במן דחסף כדי שיווסרו ממראותיהם, ג"ן, ומה שהכיור נעשה ממראות הצובאות, מפני שהכהן שהי' מקריב קיני זבות ויולדות הי' צריך להקריבן לשמן ואסור לו להסתכל בפניהם לשידע לשם איזה יקריב והיתה עומדת אצלו ומביט הוא בכיור את פניה ומקריב לשמה, מרבי:	Exodus 38:8
Paaneach Raza, Pekudei 1	@שמות פרשת פקודי	NULL
Paaneach Raza, Pekudei 2	ובעזר ציוה לעשות כיור וכן, נתחיל פקודי המשכן:	NULL
Paaneach Raza, Pekudei 3	אלה פקודי המשכן מכאן שראוי לאדם להוציא עצמו מן החשד אף במקום שאינו נחשד כמשה שנתן חשבון צודק מכל וכן גבי יהוידע, מהר"ר משה:	Exodus 38:21
Paaneach Raza, Pekudei 4	ובצלאל בן אורי וגו' ואתו אהליאב וגו', הכניס הכתוב ד"ז לכאן לומר שהם היו לו עדים נאמנים לכל חשבונותיו, כי את כל אשר צוה ה' בא לידם למלאכה, מהר"ר משה:	NULL
Paaneach Raza, Pekudei 5	כל הזהב העשוי למלאכה ותימה למה לא קחשיב בפרטיות כל הנעשה מזהב כאשר נהג אח"כ בכסף ונחושת שמנה המלאכות אשר הוצרך להם כ"כ, וע"ק דבחשבון הנחושת לא מנה קרסי הנחושת וגם המקבות וצ"ע בפ' תרומה מכל כלי המשכן, מהר"ר יעקב:	NULL
Paaneach Raza, Pekudei 6	(וי"ל דבחשבון הזהב כבר הודיענו הכתוב שעלה חשבונו מכוון, והוא דכתיב כל הזהב העשוי למלאכה וגו' ויהי זהב התנופה וגו', הרי זה כפל מפורסם דסגי למימר ויהי זהב התנופה וגו' כמו לקמן וכסף פקודי העדה וגו' ונחושת התנופה וגו', ועוד דנשתנה סדר הכתוב הזה מאד לבלתי הבין, והכי איבעי' לי' למימר, ויהי זהב התנופה כל הזהב העשוי למלאכה בכל מלאכת הקודש תשע ועשרים וגו', אלא דהכי פירושו דקרא כל הזהב העשוי למלאכה אשר עשו בכל מלאכת הקודש הוא עלה במכוון ומצומצם בחשבונו לגמרי ולא חסר כלום ויהי בין הכל כו"כ, וליותר הביאור בא טעם מפסיק בויהי להסיבו אדלעיל לומר כל הזהב העשוי למלאכה נעשה בו חשבון, ויהי, כלומר ונמצא נכון בהויתו, משא"כ בכסף שלא נתכוון החשבון מתחלה כי שכח משה להכניס תוך החשבון את כסף ווי העמודים עד שהרים את עיניו כדאי' במדרש ושלכן בא ואת האלף בטעם אזלא גרש בהרמת קול שהרים משה קולו וצווח כנז' לכן הוצרך לכתבו בפרטות חשבונו כי מתחלה לא ידע לחשוב רק כסף האדנים וכמעט שנתפס בחשבונו ואחר כך נזכר וחשב גם את האלף וגו' שעשאן ווים וגו', ואולי גם בנחושת אירע לו כיו"ב שלכן פורט והולך ששכח מעיקרא ווי נחשת או כיו"ב ועם כ"ז לא הוצרך הכתוב לכתבו אח"כ להורות שנזכר כי מובן מעצמו הוא כאשר כבר החכימו בזאת בכסף התנופה, או נוכל לומר שהחשבון ומשקל הנחושת שמנה הכתוב כולו בא בכל הנזכר בפסוק והשאר שלא נזכר כגון קרסי נחושת והמקבות הם באו מנחושת זולת שמנה הכתוב מאיזה העדפה, שמפני זה עצמו יפרוט בו הכתוב בפרוטרוט ההוא כמו בשל כסף, וזה נכון):	NULL
Paaneach Raza, Pekudei 7	וכסף פקודי העדה וגו', קשה אמאי לא קאמר וכסף התנופה כמו בזהב ונחושת, ויש לומר דבאמת הרבה והרבה הונף והורם יותר מאשר קחשיב ואי אפשר לצמצם, גם כבר כתיב והותר, גם אי אפשר שלא התנדבו גם כן פחות מבן כ' ויתרים מבן ס' שלא היו במנין שהרי כתיב כל מרים זהב וכסף ונחשת, אלא שמחצית השקל של ת"ר אלף וג' אלפים וחמש מאות וחמשים העוברים על הפקודים הם עלו במכוון למלאכת האדנים ולווי העמודים, וזה שיאמר הכתוב וכסף פקודי העדה וגו', ר"ל שכסף מחצית השקל לפקודי ונמני העדה העולים כו"כ, זה שנעשה לאדנים ולווין דוקא, ורמז בזה כאלו אמר אבל מה שהותירו העוברים על הפקודים ומה שנתנו הבלתי עוברים שאינם מפקודי העדה זה ניתן לאוצר לבדק הבית ולקרבנות קיץ המזבח וכיוצא, וכן בודאי זהב ונחושת הותירו ג"כ, רק שהכתוב לא מצא לתלות את סך הנזכר בפסוק באיזה חשבון ומלאכה לשירמוז ג"כ לומר שזה הסך הנזכר בא לחשבון אותה מלאכה לדייק לומר אבל הנותר בא לאוצר, לכן אמר בהם סתם זהב התנופה כו"כ, כלומר כל שהונף בין הכל כך וכך הוא ונמצא חשבונו מכוון מהנעשה למלאכה ומהניתן לאוצר שלא יצא כולו למלאכה כנחשת, ג"ן:	Exodus 38:25
Paaneach Raza, Pekudei 8	ואת המצנפת שש ואת פארי המגבעות שש, כבר כתבנו בפ' תצוה כי של כהן הדיוט קרוי מגבעת ושל כהן גדול קרוי מצנפת, ואל יקשה לך ע"ז דביומא מצינו גבי פייס שקורא לשל הדיוט ג"כ מצנפת דאמר נוטל מצנפת של א' מהם, דלשון תורה לחוד ולשון חכמי' לחוד ולכהן גדול נשאר מקום שני תפילין בין המצנפת ובין הציץ שהציץ הי' עולה למעלה לראש קצת כשיעור תפילין אחת ונשאר מקום אחד להניח תפילין אבל לכהן הדיוט הי' המגבעת עמוק ויורד למטה הרבה ותופס מקום של תפילין אחד (וזה שנקרא פארי מגבעות בעבור שתופס מקום א' של תפילין הנקראים פאר) ולא נשאר פנוי כ"א מקום א' לתפילין למטה והמגבעת שלו הי' קשור תחת הגרון כדכתיב וחבשת להם מגבעות ובמצנפת לא נשאר כן, מהר"ר משה:	Exodus 39:28
Paaneach Raza, Pekudei 9	כאשר צוה ה' את משה הזכיר שם משה כ"כ מפני שאמר משה מחני נא מספרך וגו' וא"ל הקב"ה חייך שאני מרבה לכתוב שמך בספרי, וע"ד המדרש במשל למלך שצוה לעבד לבנות לו פלטין וכן עשה וכתב העבד שמו של מלך על כל דבר ודבר וכו' לכן כשקרא גם המלך מיד לעבדו להכניסו לפלטין גם הוא הרבה לכתוב שמו, מר' אשר הלוי דודי:	Exodus 39:29
Paaneach Raza, Pekudei 10	וכבוד ה' מלא את המשכן כאלו אמר המשכן מלא את כבוד ה' שצמצם שכינתו לתוכו והמשכן מחזיקו, והכתוב הפוך לומר כאלו המשכן כנוס תוך כבודו ית', ג"ן:	NULL
Paaneach Raza, Pekudei 11	(ולומר שאין העולם מקומו אלא הוא מקומו לעולמו ושכל מקום לא יכיל וכו', כי כבר ידענו שהמשכן הוא דמיון כלל העולמות, ורמז שהשמים ושמי השמים וכל העולמות לא יכילוהו, וק"ל):	Exodus 40:1-2
Paaneach Raza, Pekudei 12	ולא יכול משה לבא, פירש"י נסתלק הענן נכנס ומדבר עמו, וקשה היאך א"כ נדבר עמו, הרי כל ימי החנייה הי' הענן עליו, ועוד א"כ כ"ש שאהרן ובניו לא יכלו לבא, וא"כ איך יכלו להקטיר ולהדליק ולסדר לחם הפנים, וי"ל שזה הי' ענן אחר, ושל ימי החנייה יכלו כולם לבא בתוכו, וכן צ"ל לקמן בבהעלותך, ומהר"ר אליעזר מגרמיזא תירץ דשעה אחת הי' הענן עליו ואח"כ נסתלק ונכנסין ומתקנין כל הצריך:	Exodus 40:33-34
