Paaneach Raza, Devarim 1	@דברים פרשת דברים	NULL
Paaneach Raza, Devarim 2	ובעזר בורא רוח ויוצר הרים נתחיל חומש וסדר אלה הדברים:	NULL
Paaneach Raza, Devarim 3	אלה הדברים זה ספר משנה תורה שחזר משה ושנה להם את התורה שנית ולפעמים חידש בו איזה דבר ומפני שהוא חזרת דברים אמרינן לכ"ע לדרוש בו סמוכים אפי' למאן דלא דריש סמיכות בשאר חומשי התורה וסדרותיהם, וסמך למדרש סמוכין ממאי דכתיב סמוכים לעד לעולם עשויים באמת וישר, ששה סדרות בתורה מתחילין באל"ף, אלה תולדות נח, אלה פקודי, אם בחקותי, אלה מסעי, אלה הדברים, אתם נצבים כנגד שית סדרי משנה ששנה להם ג"כ כי אלוף פי' לימוד ומשנה ג"כ פי' לימוד, הרי שרמז לששה סדרי לימוד של תורה שבע"פ, וארבע מהם מתחילין באלה כנזכר נגד ד' סדרים שיש עליהם תלמוד ובהם מסכתות כמנין אל"ה שהם ל"ו, וכנרמז בהליכות עולם ל"ו שדרשו בו אל תקרי הליכות אלא הלכות וזה אלה הדברים וגו' מלמד שחזר ושנה לפניהם גם התלמוד שנית, וחמשה מסכתות מתחילין באל"ף, פאה, פסחים, ראש השנה, בבא קמא, כלים, לרמז על לימוד של ה' חלקי תורה שבכתב והתכלית שנאוו לחייך בתורים, בשתי תורות שקשורים זב"ז וצריכות זל"ז והכל אחד מאל אחד נתנו, מרועה אחד בסיני, אל"ה רמז על ל"ו מסכתות, ל"ו כריתות, ל"ו טפחים בלוחות, ל"ו ברכות של תפלה ביום, דהיינו שחרית ומנחה, ואלו ערבית אין לה קבע, ל"ו צדיקים שבכל דור, הר"ר אליעזר:	Deuteronomy 1:1
Paaneach Raza, Devarim 4	אלה הדברים, פירש"י לפי שהן דברי תוכחות וכו' לפיכך סתם את הדברים וכו' וקשה הא אח"כ מיד בסמוך הזכיר בפירוש כ"מ שעשו ומה מפני כבודן של ישראל יש בזה, ועוד לפי שלא מצאו מקום ששמו תופל פירשו על המן, לכן נראה לפרש שסידר להם את התורה וחזרה לפניהם סמוך למיתתו כדי שלא ישכחו המצות, ואמר שאלה הדברים שיאמר להם עתה הם המה שאמרם להם כבר במדבר בעבר הירדן בערבה אחר שגזר להם הקב"ה י"ס לגזרים שזהו מול סוף כי תרגומו של ומול את ב"י הוא וגזור, ומתחיל ומסדר לפניהם כל המקומות שנצטוו להם בם תורה ומצות, ומתחיל בסיני ששם עיקר נתינת התורה, וזהו בין פארן, כי פארן וסיני אחד הוא, ובין תופל הוא מרה אשר שם שם לו חוק ומשפט ושם היו המים מר ולא יכלו לשתות מהם בלי תיקון, וכל מאכל ומשקה הצריך תיקון נקרא תפל דכתיב היאכל תפל בלי מלח, ולבן וחצרות הוא מה שנאמר להם בחצרות, וקורהו לבן וחצרות כאלו אמר שדה חצירות כי השדה יקרא שדה לבן בתלמוד, א"נ ע"ש שנצטרע שם מרים מצורעת כשלג קורהו לבן, ודי זהב הוא אהל מועד ומשכן שהי' מצופה בזהב ונעשה לו זהב לרוב, וכתיב והמלאכה היתה דים, אבל רבותינו אמרו שכל התורה נאמר בסיני ונשנית באה"מ ונשלשה בערבות מואב, בכור שור:	Deuteronomy 1:1
Paaneach Raza, Devarim 5	אל כל ישראל מלמד שכולם יכולים לעמוד בתוכחתו, ד"א שהי' משה מדבר וקולו נשמע בכל המחנה, ודי זהב, די פירושו יתר כלומר כי רעות הזהב של מעשה עגל יתירה וגדולה הוא על כל הרעות שעשו:	NULL
Paaneach Raza, Devarim 6	ד"א ויתרתם זהב בעגל גם ויתרתם זהב בכפרת יבא זה ויכפר ע"ז, לקח טוב:	NULL
Paaneach Raza, Devarim 7	אחד עשר יום מחורב, כלומר אם הולכים דרך הר שעיר דרך הישר אין מחורב עד קדש ברנע כ"א מהלך י"א יום אבל אנו סבבנו את ההר כדכתיב ונסב את הר שעיר ימים רבים, ג"ן:	Deuteronomy 1:2
Paaneach Raza, Devarim 8	ויהי בארבעים שנה וגו' דבר משה וגו', מכאן אמר רי"ח רמז לשנים מקרא וא' תרגום, כי אלה הדברים אשר דבר משה זהו א', ובכאן חזר ואמר דבר משה אל ב"י הרי שנים ואח"כ הואל משה באר וגו' שבארה היטב זה תרגום:	Deuteronomy 1:3
Paaneach Raza, Devarim 9	ככל אשר צוה וגו' מכאן שנשתלשה בערבות מואב מפי הגבורה:	Deuteronomy 1:3
Paaneach Raza, Devarim 10	הואל משה לשון שבועה כמו ויואל משה, שהשביע לישראל לקיים התורה שהרי שם נאמרו קללות שבמשנה תורה:	Deuteronomy 1:5
Paaneach Raza, Devarim 11	ראה נתתי לפניכם את הארץ מלמד שהפיל הקב"ה שריהם של אומות וכפתן לפני משה, ולכן פירש"י באו ורשו את הארץ אין אתם צריכין כלי זיין רק תקבעו תחומין וחילקו:	Deuteronomy 1:8
Paaneach Raza, Devarim 12	ובין גרו פי' שאוגר עליו דברים, אומר לו חרשת בתוך שדה שלי וזה אומר לא חרשתי וכיו"ב:	Deuteronomy 1:16-17
Paaneach Raza, Devarim 15	ד"א גרו זה שושבינו או שכנו או חתנו:	Deuteronomy 1:16-17
Paaneach Raza, Devarim 14	בגללכם שאתם הייתם מקטני אמנה, מתוך כך אמרתי המן הסלע הזה נוציא ודמיתי שלא יצאו מים, והי' לי לפרש דמצות השם יוציא מים כאשר כתבנו למעלה, ג"ן:	NULL
Paaneach Raza, Devarim 15	כאשר תעשינה הדבורים פי' שעוקצין את האדם מכאן ומכאן ואין ממיתין כך אלו הכניעו אותם ע"י הכה ופצוע ולא הרגום שלא יפערו פיהם להתגדל ויתחלל שם שמים, ותדע שהרי אין הכתוב מזכיר מנין החללים שנפלו כמנהגו במקום אחר:	Deuteronomy 1:44
Paaneach Raza, Devarim 16	ולרבינו בכור שור נראה שזהו הכנעני דכתיב בי' וישמע הכנעני וגו' וישב ממנו שבי ולא הרגם, ד"א הדבורים כשאחת יצאה כולם יוצאים, רשב"ם:	NULL
Paaneach Raza, Devarim 17	לא חסרת דבר לא כאשפזיכנא הזה שמחסר והולך יום ראשון נותן ב' מיני בשר, בשני מין א', בשלישי ירקות, אבל אתה כל מ' שנה לא חסרת דבר יום אחרון כראשון, בכור שור:	NULL
Paaneach Raza, Devarim 18	ד"א לא חסרת דבר, לא הוצרכת לחסר ממונך מאומה לקנות צרכך ואעפ"כ יש לאל ידך לקנות כל מה שתרצה כי גם זה לא חסרת:	Deuteronomy 2:7-8
Paaneach Raza, Devarim 19	מאילת ומעציון גבר, ותימה הא כתיב בדברי הימים אז הלך שלמה לעציון גבר ואל אילת על שפת הים בארץ אדום, הרי משמע שהיו לישראל, וי"ל שהיו של אחת מנשיו אשר מבנות אדום והיא נתנתם לו לאח"ז אבל מתחלה לא היו שלו, רי"ח:	Deuteronomy 2:8
Paaneach Raza, Devarim 20	אל תצר את מואב וגו', וקשה מה נ"מ בסיפור זה אליהם, וי"ל שלא ידאגו ישראל ויאמרו מדוע לא הוריש אותנו הקב"ה אלו ג' אומות עמון ומואב ושעיר, אולי ח"ו לא חפץ ה' בנו להביאנו אל הארץ, לכן אמר שמפני כבוד אבותיהם שהיו קרובים לישראל הניחם שם וק"ו לישראל:	Deuteronomy 2:9
Paaneach Raza, Devarim 21	והעוים היושבים בחצרים עתה מפרש היכן הוא ארץ החוי כי ישראל היו חושבים שהוא הר שעיר והנה העוים הוא כמו החוים כי אותיות הנרון מתחלפים, וכן בנדרים קורא לר' חייא עייא:	Deuteronomy 2:23
Paaneach Raza, Devarim 22	היושבים בחצרים אם תרצה לידע היכן הם יושבים, הלא המה יושבים בחצרים מתוך גבורתם ולא חשים לערי חומה:	Deuteronomy 2:23
Paaneach Raza, Devarim 23	ואשלח מלאכים ממדבר קדמות פי' ממקום שמקודם הי' מדבר ועתה הי' למוצא מים, כשהוציא הקב"ה מים מן הסלע:	Deuteronomy 2:26
Paaneach Raza, Devarim 24	בדרך בדרך נלך דר"ך בגימט' ט"ז אמ"ה ע"ל ט"ז אמ"ה:	Deuteronomy 2:27
Paaneach Raza, Devarim 25	אוכל בכסף תשבירני וגו' וקשה והא הי"ל באר ומן וי"ל דבמקום ישוב לא ירד להם מן דאין זה נס, והראי' דכתיב את המן אכלו עד בואם אל ארץ נושבת:	Deuteronomy 2:28
Paaneach Raza, Devarim 26	כאשר עשו לי בני עשו וגו' והמואבים וגו' לא לענין עבור בארצם אלא לענין מכירה אוכל ומים, משמע דברי מואב היו מוכרים לחם ומים וקשה הכתיב לא יבא עמוני וגו' ע"ד אשר לא קדמו אתכם וגו', וי"ל דעל דבר אשר לא קדמו קאי על לא יבא עמוני לחוד, דהוא לא קידם אבל מואבים קדמו, ואלו מואב הוא מטעם אשר שכר עליך את בלעם וגו' לא יבא בקהל, והא דאמר בפ' הערל שהותרו נקבותיהם מפני שאין דרך הנשים לקדם במים ולחם, דמשמע אתרווייהו קאי לא קדמו שהרי לא זכר בהיתר נקבות שניהם כ"א טעם זה, חדא מינייהו נקט, דה"ה שאין דרך הנשים לשכור עליהם, וכן יש במדרש מגילת רות (וע' בדברי הרמב"ן בזה בפ' כי תצא על דבר וגו' כי זהו דרכו, ולי נראה לומר ב' דרכים, א' דבודאי יאמר אשר לא קדמו על שניהם לשון רבים, ואמנם ודאי מכרו להם, אבל לא קדמו דייקא הוא שלא רצו ליתן להם המים והלחם תחלה עד שיתנו המעות מקודם, וזהו רעה גדולה למי שהוא עיף ויגע לפעמים בדרך ובמלחמה, ולכך עתה בבקשם כזאת מסיחון דקדק ואמר אוכל בכסף תחלה והדר אמר תשבירני וכן ומים בכסף והדר תתן לי ולא אמר אוכל תשבירני בכסף ומים תתן לי בכסף אלא שאמר אראה ליתן המעות תחלה, דע"ז יתכן מאמר כאשר עשו לי וגו' והמואבים וגו', ומה דנקט מואבים ולא עמונים הוא דרך רבותא שאפי' המואבים שהרעו לי ביותר אשר בהם נמצא עוד עולה אחרת דהיינו ואשר שכר וגו' ואפ"ה מכרו לי לפחות אחר נתינת הכסף, ועמון ירוע מק"ו, ואלו בדברי שליחותם הזכירו לסיחון באמת שניהם והפסוק מקצר מטעם הנזכר דנודע מכח כ"ש, ב' הוא שלא רצו למכור אכילה ושתיה יחד, שזה דקדוק שלא קדמו אתכם בלחם ובמים כלומר גם יחד רק כשמכרו להם אוכל המתינו הרבה מלמכור להם שתיה עד אחר שאכלו כבר הכל וכן להפך, וזה שאמר כאן ואכלתם והדר ומים בכסף וגו', וכן בשליחותם אל סיחון ושתיתי למי שקונה שתיה תחלה, דליקו נמי עליה כאשר עשו לי, ומה שלא הרחיק גם את עשו מטעם זה כעמון הלא כתיב בפירוש שם לא תתעב אדומי כי אחיך הוא. דהכתוב בעצמו יאמר שהי' כדאי לתעבו אלא שיתן טעם שלא לתעבו כי אחיך הוא וכן במצרי שעשה כמה רעות גדולות ואעפ"כ הועיל להם טעם כי גר היית בארצו, והנה מואב עשה שתים רעות אלה, לא קידם, ושכר עליך, ועמון אחת שלא קידם, ועשו גם הוא עשה כזאת, אלא שלא עלתה להרחיקו בשביל כך, ונקט לא יבא עמוני תחלה לרבותא דדיוקא למנקט בדרך לא זו אף זו דדייקינן ולא עמונית, כלומר לא זו עמונית דמותרת אלא אף מואבים נקבותיהם מותרות, ועוד דללא יבא עצמו נקט מואב בשניה לרבוותא דהוא איחר ביאתו בישראל בכמה דורות על הפריצות שקראהו מואב:	Deuteronomy 2:29
Paaneach Raza, Devarim 27	הנה ערשו ערש ברזל, פי' חזק כברזל שבמבצר הי"ל ברבת בני עמון שהי' מוקף חומה כברזל, וערש הוא לשון מבצר כדכתיב בעמוס היושבים בפאת מטה ובדמשק ערש, וכ"ה לשון תלמוד מערב לה לכולה מחוזא ערשייא ערשייא, תשע אמות ארכה של חומה כלומר גובהה וארבע אמות רחבה ממעל דהיינו עוביה:	Deuteronomy 3:11
Paaneach Raza, Vaetchanan 1	@דברים פרשת ואתחנן	NULL
Paaneach Raza, Vaetchanan 2	ובעזר צדיק נותן וחונן, נתחיל סדר ואתחנן:	NULL
Paaneach Raza, Vaetchanan 3	ואתחנ"ן בגימט' תפל"ה, ובגימט' שיר"ה שצריך לתפלת ניגון ונעימת קול כענין כבד את ה' מהונך ממה שחננך, ובגימט' ישר"ה אשר תפלה עולה כן, מפני שצריך להיישיר ולכוין רגליו בתפלה כמו ורגליהם רגל ישרה, ומלמד שכ"ז עשה משה בתפלתו וכן כל יסודו של פסוק זה הוא שש, שמתחיל בוי"ו שמספרה שש וששה אותיות בתיבת ואתחנן, וששה תיבות בפסוק הרי י"ח מלמד שהתפלל תפלת י"ח:	NULL
Paaneach Raza, Vaetchanan 4	את"ה החילו"ת בגימט' הת"ר הנד"ר, שאמר משה לפניו רבש"ע התר לך הנדר כמו שהתרת מה שצוית לשחוט את יצחק וזכותו יעמוד לי גם עתה, מיד א"ל אל תוסף דבר אלי בדבר הזה, בדבר בגימט' יצחק, שאל יועיל לך עתה ענין יצחק ואל תזכירנו לי בזה:	NULL
Paaneach Raza, Vaetchanan 5	ד"א כמו שהתרת נדרי ושלחתני למצרים בשליחותך אע"פ שהייתי נשבע ליתרו מלזוז מאצלו כדכתיב ויואל משה לשבת וגו', והשיב רב לך אני רבך והתרתי לך אבל לי אין לי רב שיתיר לי:	NULL
Paaneach Raza, Vaetchanan 6	אעברה נא אמר לפניו רבש"ע הירדן רחבו ג' אמה אעברה רק אמה אחת להלאה ממנו דרך א"י וזה נא נ' א', אעברה נא ואראה כי אין לי להתגעגע אלא לראי' שהרי אינני תאב לדירתה וירושתה שאני לוי ואין לי חלק ונחלה בה, לכן השיב לו וראה בעיניך שאינני רוצה להשיב פניך ריקם בזה, רבינו בכור שור:	NULL
Paaneach Raza, Vaetchanan 7	ד"א וראה בעיניך והלא זהו דרך כעס וצער יותר כמו שאמר אלישע אתה תראה ומשם לא תאכל, אלא שנתיירא משה שיחשבו עליו ישראל שבחטאיו אינו זוכה לראותה כמו מתי מדבר, לכן אמר ואראה השיב לו הקב"ה וראה בעיניך, דאלו למתי מדבר אמרתי אם יראו וגו' וכל מנאצי לא יראוה אבל אתה שא עיניך:	Deuteronomy 3:27
Paaneach Raza, Vaetchanan 8	מלמד אתכ"ם לעשות, אתכ"ם בגימט' הלכו"ת, לעשו"ת בגימט' משניות:	Deuteronomy 4:1
Paaneach Raza, Vaetchanan 9	לא תוסיפו וגו' ולא תגרעו וגו', כלומר שאם תוסיפו תגרעו כי כל המוסיף גורע שאם יעשה ה' גדילים הרי הוסיף אחת וחיסר ארבע שאינו עולה לו לקיום מצות ציצית, וכן בפרשיות של תפילין ומינין שבלולב וכן הכל:	Deuteronomy 4:2
Paaneach Raza, Vaetchanan 10	ולא" תגרעו" ממנו" לשמור" את" ס"ת בגימט' תרי"ג, שאין לגרוע מתרי"ג מצות (ורמז זה בס"ת כאשר הוא נאמר על לבסוף כשיתקיים בלע המות לנצח שיעקר יצה"ר מן העולם אזי יוכל כ"א לקיים את כולם לבלתי לגרוע מהם, אבל עתה א"א, ומ"מ כל המקיים את האפשר לו מעלה עליו הכתוב כאלו קיים את כולם, לכן אמר לא תגרעו בלשון רבים, כלומר שבין כולם לא יגרעו מהם זה עושה קצתם וזה קצתם כ"א את האפשר לו עד שסוף סוף הכל נעשה, ולרמז זה גופו ג"כ בא רמז המספר תרי"ג בס"ת לומר שאף אם אין אחד עושה כולם סוף סוף כולם נעשים:	Deuteronomy 4:2
Paaneach Raza, Vaetchanan 11	חכמתכ"ם ובינתכ"ם בגימט' טי"ב סו"ד העיבו"ר וסו"ד התקופ"ה:	Deuteronomy 4:6
Paaneach Raza, Vaetchanan 12	העידותי בכם היום את השמים וגו' וקשה הרי נוגעין בעדותן הם דכתיב אם לא בריתי וגו', וי"ל העדותי פי' אזהיר לפניכם וגו':	Deuteronomy 4:26
Paaneach Raza, Vaetchanan 13	בצר לך ומצאוך וגו' כלומר ואותך בפרטות מכל האומות וקשה למה זה לנו וי"ל דכמו כן הטיב עמנו וגמל לנו יותר מה שלא עשה לשום אומה ולשון, ג"ן:	Deuteronomy 4:30
Paaneach Raza, Vaetchanan 14	אנכי ה' אלהיך, ט' תיבות במקרא, וכן בפ' ויקרא אל משה, וכן בפ' זאת התורה לעולה למנחה וגו' לומר שאם עוסק בתורה כאלו הקריב כל הקרבנות וא"צ שום קרבן (והטעם באנכי כי הוא יתעלה רוכב בערבות למעלה מט' גלגלים על כסא רם ונשא שערבות הוא העשירי והוא חצי גלגל, ושם כסאו למעלה מט' כמנין גא"ה לומר כי הוא מתגאה על גאים באשר גם מטעם זה שת ארבע מיני גאים בכסאו, כי עד ט' מעלות הגיע הגאוה ולא יותר שהעשירי יהי' קודש לה' לשון שורש המלה גא"ה במספר ט' והוא ית' למעלה מט', כי גא"ה גא"ה, ולכך בויקרא ובזאת התורה לעולה וגו' ג"כ ט' תיבות לרמוז כי לא יזבחו עוד לשעירים כ"א לה' לבדו הרוכב למעלה מט', ולכן עיקר הזביחה הוא הכניעה ורוח נשברה להכנע לפני גא"ה גא"ה ית':	Deuteronomy 5:6
Paaneach Raza, Vaetchanan 15	הדברות מתחילין באל"ף ומסיימין בכ"ף שהוא א"ך עולה כשמו של הקב"ה הוא אהי"ה לומר כי התורה חתומה בשמו:	NULL
Paaneach Raza, Vaetchanan 16	השבת לקדשו כאשר צוך פי' כבר במרה וכן אמרו בפ' רע"ק מלמד דשבת במרה אפקוד, וקשה מנ"ל דלמא במן נפקדו שם וי"ל דמכיון דבכיבוד אב ואם כתיב ג"כ כאשר צוך לכן א"ר יהודא שם דאשניהם במרה אפקוד דמסתמא שניהם שוים, אבל קשה דאמר בפ' כל כתבי אמה שיצאו איזה אנשים מן העם ללקוט וגו' אלמלא שמרו ישראל שבת ראשונה לא שלטה בהם וכו' למה קורהו ראשונה, הלא במרה נצטוו והי' א"כ שבת א' קודם לזה, וי"ל דראשונה למן קאמר:	Deuteronomy 5:12
Paaneach Raza, Vaetchanan 17	על שני לוחו"ת אבנים, בא"ת ב"ש אותיות כס"א לומר שסנפרינון מתחת הכסא נחצבו:	NULL
Paaneach Raza, Vaetchanan 18	ואת תדבר א"ת בגימט' שמונ"ה כי שמונה דברות דיבר אליהם משה ואנכי ולא יהי' לך מפי הגבורה שמענו:	Deuteronomy 5:24
Paaneach Raza, Vaetchanan 19	ארץ זבת חלב ודבש וסמיך לי' שמע ישראל, רמז להם שלא יהי' בהמ"ק ראשון קיים להם כ"א כמנין שמע שהוא ת"י שנה (ד"א כי שמע ישראל הוא יחודא דקוב"ה ושכינתי' לכן סמכו לזה, כי שם בארץ הזאת היחוד בעצם):	Deuteronomy 6:3
Paaneach Raza, Vaetchanan 20	שמע ישראל, הפסוק מתחיל בשי"ן ומסיים בדל"ת מכאן שקורין שמע להבריח השדין, ו' תיבות בפסוק וכן בברוך שם כבוד וגו' נגד י"ב שבטים שאמרוהו לאביהם ה' אלהינו ה' אחד, זכר דוקא ג' אזכרות דאלו אמר ה' אלהינו אחד הי' מקום למינין לפרש שהוא אחד מן האלוהות אבל יש רשויות הרבה, וכן אם הי' כתוב אלהינו ה' אחד, וכ"ש אם הי' אומר אלהינו אחד, לכן אמר שה' אלהינו הוא ה' דוקא ואין זולתו והוא אחד, ואלו אמר ה' אחד היו מפרשים דקאי על שקוצם, לכן אמר אלהינו הוא הוא ה' שהרי ישראל הם הם המדברים, ואם יאמרו התועים עתה על השילוש תשובתן בצדו ואהבת את ה' אלהיך, ג"ן:	Deuteronomy 6:4
Paaneach Raza, Vaetchanan 21	(ועוד לומר כי אין כאן הפרש כלל בדין ורחמים וכל דין תחלתו וסופו רחמים):	NULL
Paaneach Raza, Vaetchanan 22	ה' אחד מאריכין באחד כדי להרגיש בכל רמ"ח אבריו, כי בקריאת שמע רמ"ח תיבות כנגדן לכן צריך ביותר להפריד בין הדבקים ולדקדק שלא לחסר אות אחת:	NULL
Paaneach Raza, Vaetchanan 23	ואהבת וגו' וקשה ל"ל הלא כבר נאמר את ה' אלהיך תירא, וי"ל בנוהג שבעולם אם אהבה אין יראה אם יראה אין אהבה, כמשל שכשאוהב חבירו בחייו אינו מתיירא ממנו, וכשמת נהפך הוא שמניחו והולך לו ומתיירא ממנו לכן אמר היזהר בך שיהי' גם אהבה גם יראה שניהם גם יחד, ד"א האהיבהו על הבריות:	NULL
Paaneach Raza, Vaetchanan 24	והיו לטוטפות פי' להגביה וליתרון כמו הלוך וטפוף דישעיה:	Deuteronomy 6:8
Paaneach Raza, Vaetchanan 25	את ה' אלהיך תירא ואותו תעבוד ובשמו תשבע פירש"י אם יש בך כל המדות הללו וכו' וקשה דאדרבא כ"ש שלא ישבע ועוד הא אמרינן דאפי' לאמת לא ישבע דכמה עיירות נחרבו על שבועת אמת, לכן י"ל ובשמו תהא מושבע שאני משביעך על שתקיים כל המדות הללו לכן נקוד תישבע ולא נקוד תשבע, לוי:	NULL
Paaneach Raza, Vaetchanan 26	ד"א שלא תשבע בשם אלהים אחרים כמפרש ואזיל, ג"ן:	NULL
Paaneach Raza, Vaetchanan 27	לא תכרות להם ברית, וקשה איך כרת שלמה ברית עם חירם ושמא כריתת ברית לע"ז דוקא אסר הכתוב, או שמא חירם גר תושב הי', א"נ לא אסר אלא ז' עממין, א"נ ברית של שלום קאמר:	Deuteronomy 7:2
Paaneach Raza, Vaetchanan 28	לא מרובכם חשק וגו' וקשה וכי בעבור היותם מעט הי' להם לטעות ועוד וכי מרובם יש לאהוב אותם, וי"ל לא מרובכם בזכות קאמר, ורשב"ם פי' יפה לחבר זאת הפרשה עם והי' עקב, וה"ק לא מרובכם וגו' כי אם מאהבת ה' אתכם וגו', וכי תאמרו א"כ ע"כ כביכול צריך לשמור השבועה אף אם לא נעמוד במצותיו לכן נאמר וידעת כי ה' אלהיך וגו' שומר הברית והחסד וגו', כלומר יעכב וימתין בו כמו ואביו שמר את הדבר וימתין לאלף דור, ומשלם לשונאיו וכו' ולכן ושמרת את המצוה וגו' והי' עקב תשמעון אז ושמר ה' אלהיך לך וגו' ולא ימתין כי אם עד לך, ג"ן:	Deuteronomy 7:7
Paaneach Raza, Vaetchanan 29	לאלף דור, לאו דוקא שהרי כתיב נוצר חסד לאלפים וכ"ש כשהדורות זה אחר זה שומרין מצותיו שיוסיף להם אהבתו:	Deuteronomy 7:9-10
Paaneach Raza, Eikev 1	@דברים פרשת עקב	NULL
Paaneach Raza, Eikev 2	ובעזר נותן תבואת גורן ויקב, נתחיל סדר והי' עקב:	NULL
Paaneach Raza, Eikev 3	"עקב "תשמעון ראשי התיבות הם "עירוב "תבשילין, שזהו עקב כי אברהם שנאמר בו עקב אשר וגו' אמרו עליו שאפי' עירוב תבשילין קיים (ולכן בא הרמז בר"ת לרמוז על אברהם שנקרא ראש אמנה), עק"ב "ת"שמעון, רמוזים אותיות שב"ת סמוכים זה לזה לומר שבת תשמעון ששקולה שבת נגד כל התורה כולה:	Deuteronomy 7:12
Paaneach Raza, Eikev 5	ד"א עקב, אלו י' דברות שיש בהם קע"ב תיבות שאם תשמעון ותקיימו אותם ושמר ה' אלהיך לך וגו' כאלו קיימת כל התורה:	Deuteronomy 7:12
Paaneach Raza, Eikev 5	ברוך תהי' מכל העמים בירושלמי אמר מכאן שכשהעכו"ם מברך צריך לענות אמן שזהו תהי' כלומר בך הדבר תלוי להחזיר ולקיים הברכה:	Deuteronomy 7:14
Paaneach Raza, Eikev 6	והסיר ה' ממך כ"ל חל"י בגימט' צ"ח אלו צ"ח קללות שבמשנה תורה (וגם חל"י לבד בצירוף המלה הוא בגימט' מ"ט אלו מ"ט קללות שבתורת כהנים שאם עקב תשמעון יסור ה' ממך את כולם):	Deuteronomy 7:15
Paaneach Raza, Eikev 7	כל חלי, אמרו בזה בהמקבל זו צנה וקשה הא אמרינן הכל בידי שמים חוץ מצנים ופחים כדאמר התם גופיה וא"כ איך יאמר עלי' והסיר ה', וי"ל דהאי והסיר ה' הוא שמזהירך אזהרה לשמור עצמך ממנה לומר כי עשה תעשה ויכול תוכל לה, מהרי"ץ. (וכבר תירצו גם בתוס' שם מה שתירצו, ולי אין נראה שום קושיא, דמ"ש הכל בידי שמים הוא ענין לשלוח המכה דע"ז אמרו חוץ מצנים וכו' שלא החזיק בידי עצמו לשולחה אבל בודאי ההסרה בה כשבאה על האדם שפיר הוי בידי שמים ככל אינך, ובטעם העיון יתיישב לך ע"ז סוגיא דהתם):	NULL
Paaneach Raza, Eikev 8	המסות הגדולות וגו', בפסוק זה ימצאו כל אותיות אלפ"א בית"א חוץ מהבי"ת, וכן בכל פסוקי אותיות של מצרים נעלמה בהם ב' מפני כי ב' פעמים יעשה הקב"ה כזאת דהיינו במצרים ולעתיד, כדכתיב כאשר שמע למצרים יחילו כשמע צור:	Deuteronomy 7:19
Paaneach Raza, Eikev 9	עד אבד הנשארים אב"ד כתיב בגימט' ז' כלומר עד שיאבד ז' עממין הנשארים והנסתרים מפניך:	Deuteronomy 7:20
Paaneach Raza, Eikev 10	כי חרם הוא כל המצוה וגו' רמז לך שהעובר על החרם כאלו עבר על כל המצות, והחרם נכנס ופועל בכל רמ"ח אבריו שהם כמנין חרם, ואם יעשה תשובה אז ברוגז רח"ם תזכור ומוחלין לו אף על החרם:	Deuteronomy 8:18
Paaneach Raza, Eikev 11	ויענך וירעיבך ויאכילך את המן ע"ז סמכה אסתר לגזור ג' תעניות ואח"כ ביום הג' נמסר המן בידה:	Deuteronomy 8:18
Paaneach Raza, Eikev 12	יחיה האדם שמלתך לא בלתה וגו', מכאן שהצדיקים לעתיד יעמדו בלבושיהם ולא בלים שמלותיהם וכ"ש גופן, זהו יחיה האדם, כלומר לעת התחיה לכך אייתר לכתבו שנית, מר' שלמה הנקדן:	Deuteronomy 8:18
Paaneach Raza, Eikev 13	ומהרריה תחצוב נחושת, פי' נחשת צרוף שא"צ שום תיקון מלאכה דאל"כ מה רבותיה משאר ארצות:	Deuteronomy 8:18
Paaneach Raza, Eikev 14	ושבעת וברכת את וגו', לרבות בעל הבית מכאן סמכו לקבוע לו ברכה בברכת המזון (וצ"ע דהא ילפינן לי' מואברכה מברכך לפ"מ שדרשו בו מי שנותנין לו כוס לברך ואינו מברך מקצר ימים וע' ברש"י שם):	Deuteronomy 8:18
Paaneach Raza, Eikev 15	נחש שרף ועקרב וצמאון אשר אין מים וגו', מה ענין זל"ז, דאם הנחש נושך לאדם אם יקדים הנחש למים ימות האדם, ואם האדם יקדים לבא למים ימות הנחש, וכאן הי' זה נס מופלג שכל הנשוך מצא מיד מים, מפי הר"ר מאיר, (וזהו שאמר מיד המוציא לך מים וגו' שהמציא לך את המים):	Deuteronomy 8:18
Paaneach Raza, Eikev 16	והנה עם קשה עורף הוא כלומר שהעורף הוא כאלו אין בו פרקים וחוליות רק קשה שאינם יכולין לכוף אותו לקבל עול, בכור שור:	Deuteronomy 8:18
Paaneach Raza, Eikev 17	ואתנפל לפני ה' כראשונה וגו', פי' שכמו שהתנפלתי במ' יום הראשונים על אמרו הרף ממני ואשמידם שלא ישמיד אתכם וניאות לי שלא להשמיד אבל לא מחל כדכתיב וינחם ה' וגו' ככה התנפלתי בשניים למחול לגמרי:	Deuteronomy 8:18
Paaneach Raza, Eikev 18	ואתנפל לפני ה' את ארבעים וגו', אשר התנפלתי וגו', ואתפלל וגו', פירש"י דהן הן מ' יום השניים שזכר בסמוך, באמרו ואתנפל לפני ה' כראשונה רק שכפלן כאן להזכיר סדר תפלתו, וקשה ל"ל להזכיר גם סדר תפלתו כלל, וי"ל דלחכמה גדולה עשה זה משה ע"ה כדי שאל ידמו בנפשם הלא חטאה גדולה חטאנו בדבר העגל ונמחל בתפלה בעלמא, הן יש מקום לחטוא עוד כהנה וכהנה בהיותינו בארץ ויהא נמחל הכל בתפלה, לכן סידר לפניהם תפלה זו ואמר שהתפלל שיעשה הקב"ה מפני חילול שמו הגדול שזהו אל תשחת וגו' פן יאמרו וגו', ובעבורה ניאות השי"ת וקבל תפלתו, אבל כשתחטאו עוד בארץ אח"כ אין דבר זה שייך עוד ולא ימחול לכם ותתחייבו ח"ו כלייה (והנה בא הכתוב לומר כאן את ארבעים היום וארבעים הלילה בההי"ן הידיעה משא"כ לעיל בסמוך כדי להורות בפירוש כדברי רש"י דלא אחריני נינהו רק אינהו נינהו הידועים כבר לעיל ונזכרים בסמוך, וליותר הביאור עוד אמר משה מותר אשר התנפלתי, שבזה פי' בעצמו הדבר, ואמר כונתי בואתנפל הזה השני על המ' יום עצמן אשר זכרתי כבר בסמוך בואתנפל הראשון שאמרתי שהתנפלתי בהם, ואין רצוני עתה למ' יום אחרים שלשים, רק שמפני לבאר סדר תפלתי זכור אזכרם עוד לכם עתה):	Deuteronomy 8:18
Paaneach Raza, Eikev 19	בעת ההוא אמר ה' אלי פסל לך פי' שמחל וצוה לפסול לוחות אחרות תחת אותן ששברתי:	Deuteronomy 8:18
Paaneach Raza, Eikev 20	פסל לך פי' אתה צריך לפסול ובשבילך הוא שלא יתרעמו עליך ישראל לומר דבר גדול הפסדתני:	Deuteronomy 8:18
Paaneach Raza, Eikev 21	ועשית לך ארון עץ וגו' הוא ארון עץ שעשה לו משה בעלייתו להר סיני ואיננו ארון זהב שעשה בצלאל במלאכת המשכן ומ"מ גם בזה היו הלוחות מונחים או גם שברי לוחות למר כדאי"ל ולמר כדאי"ל עד שנעשה ארון הזהב וזה הי' יוצא עמהם למלחמה, ועליו נאמר וארון ברית ה' נוסע לפניהם, אבל של בצלאל הניח בו אח"כ לוחות אחרונות ולא הורגל לצאת עמם למלחמה כדכתיב בשילה אוי לנו כי לא היתה כזאת אתמול שלשום וגו' מי מצילנו מיד האלהים האדירים האלה וכשהוליכהו לקו עליו, ובו אמרו כ"ז שאין ארון ושכינה במקומן אסורים ישראל בתשמיש, ובמלחמת יהושע הי' עמהם ע"פ הדיבור, והא דכתיב באוריה הארון וישראל וגו' ועבדי אדוני על פני השדה חונים וגו' ואני אבא וגו' ולשכב עם אשתי, דמשמע שהחמיר ע"ע אבל בדין הי' מותר, גם זה הי' ארון עץ שעשה משה, ובירושלמי יש פלוגתא בזה, חד סבר ב' ארונות היו וחד סבר ארון א' הי', ג"ן:	Deuteronomy 8:18
Paaneach Raza, Eikev 22	פסל לך ואח"כ ועשית לך ארון עץ, ומשה עשה בהפך כדכתי' ואעש וגו' ואפסול וגו', וקשה למה לא חשיב לי' נמי בפ' רע"ק בהדי הנך ג' שעשה משה מדעתו והסכימה דעת המקום על ידו, מהר"ר משה:	Deuteronomy 8:18
Paaneach Raza, Eikev 23	(וי"ל דהרי קחשיב בהו ששיבר את הלוחות ושמעינן בו שפיר שהסכים הקב"ה גם בזה מדכתיב כאן אשר שברת שפי' יישר כחך ששברת וסמיך לי' ואעש וגו' ונכלל א"כ גם הוא בהאי יישר כחך, ועוד אפ"ל ביותר הביאור דמדקאמר אשר שברת ושמתם בארון משמע תיכף לשבירה ישימם בארון מקודם שיפסול לוחות אחרות וזה עצמה ההסכמה על עשיית הארון קודם שאמר כן מפני שגלוי הי' לפניו יתברך שמשה יעשה בהפך וכמסתבר ומוכרח וא"כ הוי כאלו הוא ית' עצמו צוהו כך לכן לא חשיב לי' בהדי הנך הסכמות, ומה שאמר הש"י מתחלה באמת פסל לך קודם לועשית ארון עץ הוא מטעם להורות תיכף בלי המשך שקבל תפלתו ומחל כמ"ש לעיל בסמוך, לכן סמך מאמר פסל לך תכף לתפלתו, ואלו בהקדימו ועשית ארון עץ לא הי' מובן מחילה עדיין עד מאמר פסל לך המאוחר דועשית הוי כל מובנו לשברי לוחות, ובלא"ה צריך עכ"פ ליתן טעם בכל מה שציוהו השי"ת הפך ממה שהסכימה דעתו ית' למה ציוהו תחלה בהפך):	NULL
Paaneach Raza, Eikev 24	ושמתם בארון לא תוליכם עוד על ידך כדי שלא יהו מצויות לישבר אם תכעוס כאשר עשית כבר, בכור שור:	NULL
Paaneach Raza, Eikev 25	(ואין זה סותר למה שאמרו שהסכימה המקום בשבירתן דבפעם אחרת לא היתה דעתו מסכמת עוד, וזה הורה לו באמרו ושמתם בארון שלא תנוח דעתו בזה עוד לכן לא ישברם עוד):	Deuteronomy 9:12
Paaneach Raza, Eikev 26	נסעו מבארות וגו' שם מת אהרן פי' שם מת דהיינו בסוף מ' שנה ומעשה העגל הי' בתחלת מ' באופן שלא מת בעון זה שלא תאמר הלא כתיב ואתפלל גם בעד אהרן וגו' ומה הועילה תפלתו, לכן אמר שם מת:	NULL
Paaneach Raza, Eikev 27	נסעו מבארות בני יעקן מוסרה שם מת וגו' פי' הג"ן בדרך שפי' הראב"ע, ותמוה הוא מכמה טעמים וכבר השיגו הרמב"ן ז"ל ועיין עליו:	Deuteronomy 10:6
Paaneach Raza, Eikev 28	לעמוד לפני ה' לשרתו פי' כי מה שהיתה כבר העבודה לבכורים איננו נכון כי מאחר שאין העבודה בתולדות זה אחר זה שיהא הבן רגיל ובקי ממה שלמד מאביו ומאבותיו וראה מהם תמיד יבא א"כ לידי קלקול ח"ו שכשיבא בכור א' לשמש אשר אביו ואבי אביו לא היו בכורים ובני משפחתו לא הורגלו בעבודה, לא ידע משפט אלהי הארץ ויקלקל לכן בחר הקב"ה בשבט שלם מיוחד לכך ובפרט בשבט שעמדו כבר באמונתן ולא טעו בעגל שכל השבט ירגילו בכך ולכן לא נתן להם נחלה עם אחיהם שלא יתעסקו בדבר אחר ויעמדו תמיד בקדושת עבודתו ושירותו, זהו לעמוד לפני ה' וגו' ושלא תקשה א"כ ממה יתפרנסו אמר ה' הוא נחלתו במה שצוה לישראל לחרוש לזרוע ולקצור גם להם בתת להם מעשר דגן תירוש ויצהר וערים לשבת, זה כל המשך וסדר שני פסוקים אלה, קחם נא אליך לעיניך בקראך דברים אלה וינעם לך, בכור שור:	Deuteronomy 10:8
Paaneach Raza, Eikev 29	ואנכי עמדתי בהר וגו' בקבלתי לוחות אחרונות שעלה בר"ח אלול וירד בעשרה בתשרי שהוא היום שא"ל סלחתי כדברך ולכן הוקבע למחילה וסליחה וזה הי' ביום ב' שהרי פסח שלפניו שיצאו בו ממצרים הי' ביום ה' שהרי לקחו שה לבית אבות בעשור שהי' בשבת שע"כ נקרא שבת הגדול ע"ש נס הגדול שלקחו וגררו אלהיהם לעיניהם ולא אמרו להם דבר, וא"כ ע"כ גם י"ז בתמוז הי' בחמישי בשבת דט' באב וי"ז בתמוז חלים ובאים ביום שחל בו להיות פסח שלפניהם כסימן א"ת ב"ש וכו' וכרמז על מצות ומרורים, וכן ביום י"ז בתמוז ירדו לוחות ראשונות ונשתברו, הרי שבאו ביום ה', וראש השנה שלאחריו הי' ביום שבת בשלישי של פסח כסי' א"ת ב"ש ג"ר הנ"ל, וא"כ הי' יו"כ של אותה שנה ביום ב' ובו ירדו לוחות אחרונות ומכיון שירדו לוחות ביום ה' וביום ב' תיקן עזרא שבהם יהיו קורין בתורה ולא יהיו לעולם ג' ימים בלא תורה ולא תשתכח, ולטעם זה גם בתי דינין יושבין בהם, שמתוך שבני הכפרים נכנסים לכרכים לשמוע תורה באים ג"כ לדין וסימנך בצד"ק תשפו"ט, כי כוכב צדק משמש בראש יום ה' ובראש ליל ב', כדאמרינן במס' שבת כצנ"ש חל"ם, כצנ"ש ראשי ימים חל"ם ראשי לילות, בכור שור:	Deuteronomy 10:10
Paaneach Raza, Eikev 30	ועתה ישראל מ"ה ה' שואל וגו' דרשו מזה ק' ברכות, וזהו ג"כ שאמר הכתוב על מ"ה אדניה הטבעו, כלומר על ק' אדנים שבמשכן העולם עומד שכנגדן תקנו ק' ברכות בכ"י דבזה כתיב ג"כ מ"ה ואל תקרי וכו' כי האדנים היו מאה לומר שכל המקיים ק' ברכות בכ"י זוכה לבנין הבית, והנה דבר זה כתוב בתורה ושנוי בנביאים ומשולש בכתובים, כתוב בתורה כדאמרן מ"ה ה' שואל וגו', שנוי בנביאים נאום הגבר הוקם ע"ל וכתיב בי' ונעים זמירות ישראל, שזמירות ישראל יהיו כן, ומשולש בכתובים הנה כ"י כ"ן יבורך גבר ירא ה':	Deuteronomy 10:12
Paaneach Raza, Eikev 31	כי אם ליראה וקשה וכי מלתא זוטרתא הוא ופי' הג"ן דתחלת פסוק זה מוסב וקאי אסוף פסוק שלאחריו דהיינו לטוב לך כלומר מה כל שאילתו ממך בכל המצות חקים ומשפטים הרבים והגדולים כ"א לטוב לך:	Deuteronomy 10:12
Paaneach Raza, Eikev 32	את ה' אלהיך תירא מלעבור אזהרותיו, דהיינו מצות ל"ת, אותו תעבוד, זו מצות עשה ובו תדבק שלא תפרד ממנו לעולם כי כל כאין נגדו:	Deuteronomy 10:12
Paaneach Raza, Eikev 33	ובשמו תשבע מלהזכיר שם אלהים אחרים ושתהא מושבע ועומד בשמו כלומר כל הזכרת שמו ית' יהי' בעיניך כשבועה חמורה, בכור שור:	Deuteronomy 10:20-21
Paaneach Raza, Eikev 34	הוא תהלתך שמא [שמה] שהוא מלך ואדון לך הוא תפארתך:	Deuteronomy 10:21
Paaneach Raza, Eikev 35	והוא אלהיך דיין ונוקם שלך:	Deuteronomy 10:21
Paaneach Raza, Eikev 36	ככוכבי השמים לרוב לאו דוקא אלא שדברה תורה בלשון הבאי כמו ערים גדולות ובצורות בשמים, רבינו בכור שור:	Deuteronomy 10:22-11:1
Paaneach Raza, Eikev 37	בעתו יורה ומלקוש דהיינו יורה בחשון ומלקוש בניסן דהיינו רביעה ראשונה ושניה, באופן שאח"כ ואספת דגנך וגו' בלי מטר:	Deuteronomy 11:14
Paaneach Raza, Eikev 38	כי אם שמור תשמרון, כפל השמירה לומר כמו שתשמור מעותיך מלאבדם כך תשמור מלאבד תורתך שקשה הוא למצא בכסף וזהב, (ד"א כי אם שמור מקצת, תשמרון את כל המצות, שמצוה גוררת מצוה, ושכר מצוה מצוה, וכן נמי לענין הלימוד שנעשה כמעין המתגבר שומע ומוסיף, ונדרש דדיה ירווך בכל עת, שבכל עת אתה מוצא טעם חדש, ד"א לענין הלימוד, אם שמור, כלומר שתלמדו ותתמידו בלימודה כי ושמרתם זו משנה, אזי תשמרון את כל המצוה וגו' לעשותה כבמדרש שהמאור שבה מחזירן למוטב, וכן אמרו תלמוד גדול שמביא לידי מעשה, א"נ כולו לענין הלימוד, אם שמור שתתמיד בלימוד, אזי תשמרון ולא ישתכח תלמודך כענין חזור חזור וכו'):	Deuteronomy 11:22
Paaneach Raza, Re'eh 1	@דברים פרשת ראה	NULL
Paaneach Raza, Re'eh 2	ובעזר האומר הנה ילך לפניך מלאכי, נתחיל סדר ראה אנכי:	NULL
Paaneach Raza, Re'eh 3	ראה אנכי נותן לפניכם היום וגו' כלומר בעוה"ז הוא כך, שניתנו ברכות וקללות אבל בעוה"ב כולו ברכה:	Deuteronomy 11:26
Paaneach Raza, Re'eh 4	את" הברכה" אשר" תשמעו" ס"ת אותיות תור"ה כלומר שתשמעו את התורה (ובאו אותיות תורה בס"ת ובערבוב שלא כסדרן לומר כי זה יהי' בסוף ולעתיד לבא שישמעוה מקטנים ועד גדולים וכולם ידעוה כדכתיב כי מלאה הארץ דעה את ה' וגו', שכולם קטן כגדול כמו שהם בערבוביא כולם ידעו את התורה לעתיד ולבסוף והוא עצמו ג"כ רמז עקב אשר תשמעו, כלומר לבסוף, ואולי הוא כולו רמז על תורה חדשה שעתיד הוא ית' לדרוש להם מתורה שבחיקו, ועוד הורה בזה שמה שאמר את הברכה אשר תשמעו וגו' לא שבשביל כך ישמעו ויהיו כעבדים המשמשים את הרב ע"מ לקבל פרס רק יעשו זה מאהבה ויראה גם יחד בערבוביא שלא לשם שום שכר וסוף הכבוד לבא מאליה, לכן בא הרמז בס"ת ובעירוב, ועוד ששכר התורה סופה לבא היום לעשותם ומחר ליטול שכרם, וזהו ג"כ עירוב האותיות וס"ת לומר לצפות השכר לבסוף כשיהיו הכל מעורבבים לעוה"ב, והיינו כשיהי' קטן וגדול שם הוא ועבד חפשי מאדוניו, ועוד הורה לנו בזה שיתארך הגלות החל המר הזה זמן ארוך ומופלג מאד עד לבסוף דהיינו ששלימות התורה שהכל ידעוה זה יהי' לבסוף הרבה וכל כך עד שם נתערב אנו בין הגוים והאומות):	Deuteronomy 11:32
Paaneach Raza, Re'eh 5	שאל מין א' את הרב ר' נתן בן רבינו משולם סבת אריכות הגלות הזה כ"כ ולא כן גלות בבל שבא על ע"ז שאין עון חמור ממנה ואעפ"כ לא הי' כ"א ע' שנה, והשיב דבבית ראשון עשו צלמים ואשרות וכלים שלא לקיימא אבל בבית שני עשו ע"ז מבני ישראל עצמן דהיינו לאותו האיש ותלמידיו והפכו עליהם הנבואות הקדושות וקבעוהו לע"ז קיימת ומקובלת לעובדי' לכך הדבר חמור ועונש כ"כ, והג"ן השיב כי לגאולת מצרים ובבל לא הי' כ"א איבוד אומה אחת אשר ישראל בידה וזה לא הי' קשה כ"כ בעיני הש"י אבל עתה ישנו עם א' מפוזר ומפורד בין כל העמים ויצטרך לזה שיהפך ידו על כולם וזה קשה בעיניו מאד ולא נקל ממהר האלהים לעשותו:	NULL
Paaneach Raza, Re'eh 6	אלה החקים והמשפטים וגו' כל הימים אשר אתם חיים וגו', פי' שינהגו לעולם כ"ז שאתם חיים אף בחוצה לארץ, וכדי שלא תאמר שאינם נוהגים אלא בהיותם בארץ מכיון שכתוב לפניו תשמרון לעשות בארץ וגו' לך לרשתה וגו' לכן חזר ואמר כל הימים וגו' כנזכר, בכור שור:	Deuteronomy 12:1
Paaneach Raza, Re'eh 7	(והא דנקט תחלה תשמרון לעשות בארץ עד שצריך לחזור ולתקן הדבר, לא לכתוב לא ה"י ולא וי"ו, היינו משום דאצטריך תרווייהו, דקצתן באמת אינן נוהגין אלא בארץ ככל חובת הקרקע וקצתן אף בחו"ל ככל חובת הגוף לכן אמר תחלה תשמרון לעשות בארץ וגו' ושלא לטעות ולומר כן בכל חזר ותקן הדבר בכל הימים):	NULL
Paaneach Raza, Re'eh 8	איש כל הישר בעיניו פי' מלהפריש תרומות ומעשרות ולעלות לרגל ולהביא קרבנות שמה רק למשכן הסמוך להם, ע"ז קאי כל הישר בעיניו שהם הם הדברים הבאים אח"כ בפרשה, בכור שור:	Deuteronomy 12:8-9
Paaneach Raza, Re'eh 9	אל המנוחה, שינוח ה' לכם מכל אויביכם מסביב כדכתיב לקמי', ואל הנחלה שתעברו את הירדן לרשת ולענין כי לא באתם עד עתה, זכרם בסדר לא זו אף זו, לא זו שלא באתם עד עתה אל המנוחה אלא אף אל הנחלה שהוא לעבור את הירדן לא באתם עדיין, ג"ן:	Deuteronomy 12:10
Paaneach Raza, Re'eh 10	בכ"מ אשר תראה פי' תרצה ותחפץ כמו לעוות אדם בריבו ה' לא ראה:	Deuteronomy 12:13-14
Paaneach Raza, Re'eh 11	על הארץ תשפכנו כמים דלא תימא כיון דהוקש פסהמ"ק שנפדו לצבי ואיל בפסוק הזה ליטעני נמי כיסוי כמותם קמ"ל:	NULL
Paaneach Raza, Re'eh 12	רק הדם לא תאכלו וגו' פי' שלא תאמר כמו שבשרם שאף שהי' אסור קודם הפדיון הותר עתה בפדיון ככה גם הדם מותר וכן ה"ה שחלבם לא הותר, רק דנקט הדם מפני דאי"ל למימר ביה עוד מלתא אחריתא דהיינו על הארץ וגו', ג"ן:	Deuteronomy 12:16
Paaneach Raza, Re'eh 13	השמר לך פן תעזוב וגו' הרי ב' לאוין כיון שהוא שמש של הקב"ה:	Deuteronomy 12:19
Paaneach Raza, Re'eh 14	על אדמתך פירש"י אבל בגולה אינך מוזהר עליו ביותר מעל עניי ישראל, ונראה הטעם דבא"י יש לישראל נחלה וללוי אין לו לכן צריך ליתן עיניך עליו, אבל בגולה גם לישראל אין לו נחלה לכן שניהם שוים שם, בכור שור:	NULL
Paaneach Raza, Re'eh 15	(ולי נראה הטעם דשם הוא במקום שימושו לכן מוזהר עליו ביותר להחיותו ולהספיקו, אבל בחו"ל אינו בשימושו אין מוזהרין עליו יותר, ד"א כי הארץ הוא אשר עיני ה' אלהיך בה וגו' להשפיע לך בעצמו וכבודו מבלי שום סירסור ואמצעי לכן צריך גם אתה לשום עיניך בפרטות על בני פלטין דידי', דהיינו להקדימם, אבל בחו"ל שהוא שותה ע"י א"י כשם שאתה מושפע באגב בלי השגחה פרטית כך אינך מחויב להשפיע לשום זולתך בהשגחה פרטית כ"א באגב דהיינו שיהיו שניהם שוים לך):	NULL
Paaneach Raza, Re'eh 16	וזבחת וגו' כאש"ר צויתי"ך בגימט' רו"ב האח"ד בעו"ף ורו"ב השני"ם בבהמ"ה, ר"י מקורבייל:	Deuteronomy 12:21
Paaneach Raza, Re'eh 17	ובא אליך האות והמופת, בנביא שהי' בתחלה נביא אמר ובא אז האות והמופת על הדבר שדיבר אליו השם ואח"כ הוא נביא שקר ואומר לסמוך עליו מכח אותות הראשונים שעשה לעיניהם ונתאמתו מיירי קרא כדאיתא בברייתא ואין לתמוה למה א"כ עשאו ית' נביא מתחלה ולא חש לשמא יטעה את בניו בכך, דזהו דאמר קרא כי מנסה ה' וגו' שאעפ"כ תזהר מלשמוע לו עתה בשקוריו, ג"ן, וק"ו שאין להשגיח במופתים שע"י מכשפות ומעשה תיעתועים כמו של המתעה הגדול שלא הי' נביא אמת מעולם ולא הסכים הש"י על יד מופתיו:	Deuteronomy 13:3
Paaneach Raza, Re'eh 18	כי דיבר סרה וגו' פי' כדי להסיר אתכם מאחרי הש"י, ג"ן:	NULL
Paaneach Raza, Re'eh 19	כי יסיתך אחיך בן אמך לרבותא נקטיה שאף שהאח מן האם הוא ביותר שהיו בבטן א' וינקו שדי אחת ואלו אחים מן האב שונאים זל"ז מפני הנחלה, משא"כ באם שאין רגילות להיות לה להנחיל בעבור שאין בת יורשת נחלה במקום בן בכור:	Deuteronomy 13:7
Paaneach Raza, Re'eh 20	ולא ידבק בידך מאומה, שלא יאמרו שלא לכבוד שמים כי אם לאהבת ממונם הרגתם, וזה כליל לה' אלהיך שידעו שכל הנעשה נעשה לשם ה':	Deuteronomy 13:18
Paaneach Raza, Re'eh 21	ונתן לך רחמים כיון שלא רחמת על מכעיסיו, ג"ן:	Deuteronomy 13:18
Paaneach Raza, Re'eh 22	בנים אתם לה' אלהיכם ולא תתגודדו וגו' כי אף שמת לך אביך הלא יש לנו אב זקן חי וקיים לעולמי עולמים, משא"כ באומות המתגודדים על מת באשר אין להם אז עוד אב קיים כי אומרים לעץ אבי אתה, ג"ן:	Deuteronomy 13:18
Paaneach Raza, Re'eh 23	(והוא שאמר ירמי' יתומים היינו ואין אב האי אין אב מיותר הוא, דפשיטא אם נעשינו יתומים שאין להם אב, אלא פי' יתומים היינו אבל לא מצד האב רק כיתומים שמן האם היינו דשכינה וכנ"י אין לנו אבל האב המרחם הוא חי וקיים לנצח, וכן אמר דוד כאבל אם קודר שחותי ולרז"ל שדרשו לא תתגודדו לא תיעשו אגודות אגודות ג"כ מקושר יפה עם בנים אתם לה' אלהיכם שמכיון שבנים אתם לאל א' ומיוחד אל תפנו אל הפירוד ליעשות אגודות אגודות מחולקות שונות רק תהיו כולכם פונים אל היחוד וכל מעשיכם יהיו לשם יחודא וזה ג"כ ולא תשימו קרחה בין עיניכם, כינה כלפי מעלה, כלומר שבזה ח"ו תעשה קרחה ופירוד למעלה כנודע, וזה למת שאז הייתם נוטים לאלהי עץ ואבן הנקראים מת אשר החילוק והפירוד דבר בם ולא כאלה חלק אל חי אחד הוא בוראינו ית'):	Deuteronomy 13:18
Paaneach Raza, Re'eh 24	לא תאכל כל תועבה דרשו רז"ל כל שתיעבתי לך כלומר שכבר נעשה בו דבר האסור לישראל לעשות הוא בבל תאכל, וקשה איך אנו אוכלין בהמות ועופות המסורסים הלא בכלל שתיעבתי לך הוא, שהרי אנו מוזהרין מלסרס, וי"ל דקרא החזירן להתירן לנו לאכילה מדאיצטריך למיסר המסורס להקרבה לגבוה:	Deuteronomy 13:18-19
Paaneach Raza, Re'eh 25	וא"ת החזי"ר בגימט' שעי"ר ואדו"ם והוא אותיות אחז"י תור"ה, לומר שאותן שאחזו התורה וקבלוה המה יאכלו החזיר הזה, ד"א לרמוז שעתיד להחזירו לישראל אוחזי התורה להתירו להם כמו שדרשו משמו:	NULL
Paaneach Raza, Re'eh 26	כ"ל צפו"ר בגימט' עו"ף טהו"ר (והאי דכתיב קרא עוד בפירוש טהורה הוא מפני כי מלת כל אתי לרבות משולחת שבמצורע, לכן אמר נמי עלה טהורה לשון נקיבה לעורר על שרמז עליה כי שם במצורע נזכרו בכל הפרשה בלשון נקבה שתי צפרים חיות טהורות וכן הכל:	Deuteronomy 14:2
Paaneach Raza, Re'eh 27	עור"ב למינ"ו בגימט' זרז"ר כדאמרינן לא לחנם הלך הזרזיר וכו':	NULL
Paaneach Raza, Re'eh 28	ואת בת היענה, אמר בת משום שאינה ראויה לאכילה כי אם בקטנותה, דבגדלותה בשרה קשה כעץ וכגידין קשין, ג"ן:	Deuteronomy 14:15
Paaneach Raza, Re'eh 29	לא תבשל גדי וגו' דדלמא שהבהמה שהחלב הזאת יוצאה ממנה היא אמו ואין דרך אכזריות גדול מזה לבשל הולד בחלב אם, בכור שור:	Deuteronomy 14:21
Paaneach Raza, Re'eh 30	(ותמה אני אם מפה קדוש יצאו הדברים האלה דלמה לא יהא נאסר לומר טעם זה כמו האומר על קן צפור יגיעו רחמיך):	Deuteronomy 14:21
Paaneach Raza, Re'eh 31	ל"א תבש"ל גד"י בגימט' הי"א איסו"ר אכיל"ה ובישו"ל והנא"ה:	Deuteronomy 14:21
Paaneach Raza, Re'eh 32	עשר תעשר נסמך ללא תבשל גדי לומר שלענין המעשרות א"צ להמתין על בישול וביכור, ד"א שכל הנזהר מלבשל גדי בחלב הקב"ה מגדל פירותיו באופן שיבא לידי עשר תעשר:	Deuteronomy 14:22
Paaneach Raza, Re'eh 33	היוצא השדה שנה שנה, פי' אם עשר תעשר שנה שנה אזי תתעשר אתה ואם לאו הרי היוצא השדה דהיינו עשו איש שדה יהי' העשיר שיקח את כל תבואתך, זהו עשר תעשר כלומר או הוא יהי' עשיר זולתך או תעשיר אתה, וא"כ יפרש מי הוא זולתו שיעשיר אם לא תתן מעשרות ואמר שהוא היוצא השדה, ג"ן:	Deuteronomy 14:22
Paaneach Raza, Re'eh 34	ואכלת לפני ה' וגו' בכורות צאנך וגו', וקשה הלא ישראל אינו אוכל בכורות וזה לא מצי מיירי בבעל מום דאכיל לי' ישראל דהדר כתיב בפ' כל הבכור וכי יהי' בו מום, והר"ר משה ממחסיא מצא בס' אחד שהיו נוהגים להפריש שני מיני בכורות, א' פטר רחם, וא' אף שאינו פטר רחם רק שהוא הנולד ראשון בעדרו כמו ביכורי אילנות והוא נאכל לבעלים, מהר"ר מנחם בר נטרונאי:	Deuteronomy 14:23
Paaneach Raza, Re'eh 35	(ואולי להפריש נולד ראשון בעדרו אם אמת נכון הדבר נעשתה מצאו להם סמך מפ' ביכורי אילן דכתיב מראשית כל פרי האדמה, כל לרבות פרי בהמות, א"נ מכיון שטעם פסיק שמראשית מפסיק מלת מראשית ממלת כל פרי האדמה ירמוז עוד ראשית אחר שלא מפרי האדמה:	NULL
Paaneach Raza, Re'eh 36	"רק "אם "שמוע "תשמע "בקול "ה' ר"ת אותיות בראשית לומר כי העולם קיים בשביל ישראל שהם ראשית תבואתו ששומעים בקולו כמו שבבראשית ברא נרמז שבשבילם נברא כך נרמז כאן שבשבילם קיים (ולכן נרמז בר"ת להורות על כי מראש נברא בשבילם וסדר האותיות בזה האופן הוא כסדרן "בקול "רק "אם "שמוע "ה' "תשמע, לומר כי אף רק בקולך דהיינו בתפלה ובק' ברכות אם שמוע ה', כלומר שתשמיע אליו רק בזה אזי ה' תשמע, כלומר גם הוא ישמע ויקשיב לקולך לקבל תפלתך):	Deuteronomy 15:5
Paaneach Raza, Re'eh 37	"די "מחסורו "אשר "יחסר ר"ת דמא"י לרמז שמאכילין את העניים דמאי, מצאתי. (דוקא בר"ת לומר שבראש וראשון, כלומר לכתחלה מותר ולא תימא דוקא אי לית לך מידי אחרינא):	Deuteronomy 15:8
Paaneach Raza, Re'eh 38	ופנית בבוקר והלכת לאהליך, לפי הפשט קשה היאך יכול לילך לאהלו בבוקר ט"ו הלא יו"ט הוא, וי"ל דיוכל לילך חוץ לירושלים בתוך התחום ללכת דרך אהלו, מהר"ר חיים:	NULL
Paaneach Raza, Re'eh 39	א"נ שפי' לילך לאשפזיכני' שא"צ לעמוד במקדש, לוי:	NULL
Paaneach Raza, Re'eh 40	וזכרת כי עבד היית וגו', וקשה למה כתיב זה יותר בעצרת מבשאר מועדים, ומאי יציאת מצרים שייך בעצרת, וי"ל דאמר הקב"ה בהוציאך וגו' תעבדון את האלהים על ההר הזה, וזהו קבלת התורה, ולכך כתיב ומשה עלה וגו' שמעצמו עלה בלי רשות לידע אם תעבדון הזה הוא לעבודת קרבנות או לשאר מצות והשיב לו ית' שהוא לקבלת תורה ומצות, וז"ש לא דברתי את אבותיכם על דבר עולה וזבח:	Deuteronomy 15:15
Paaneach Raza, Re'eh 41	באספך מגרנך ומיקבך לפי הפשט יש לפרש כיון שעשית לך סוכה לצרכך כבר לשמור התבואה שבשדות לכן עתה באספך וגו' תעשה עוד סוכה לשמו ית':	Deuteronomy 16:13-14
Paaneach Raza, Re'eh 42	שבעת ימים תחוג שאין לך עוד על מה לדאוג שהרי אספת כל תבואתך, זהו כי יברכך ה' אלהיך בכל תבואתך וגו' ולכן והיית אך שמח שאין לך עוד לעסוק בשום דבר כי אם בשמחה משא"כ בפסח שאתה דואג על התבואה שהוא בשדה לכן כתיב שם ופנית בבוקר וגו', בכור שור:	Deuteronomy 16:15
Paaneach Raza, Re'eh 43	אך שמח פירש"י לרבות ליל יו"ט וכו', וקשה הלא אכין ורקין מיעוטין הן ואיך כאן מרבינן מיני', וי"ל דמשמחה יתירא מרבינן דהא כבר כתיב ושמחת ולא מאך ילפינן לי':	Deuteronomy 16:15-16
Paaneach Raza, Re'eh 44	שלוש פעמים וגו' כתיב שלוש מלא בוי"ו כי ו' פעמים צריך להקביל פני רב, בג' רגלים ובר"ה ויו"כ ושמיני עצרת:	Deuteronomy 16:16
Paaneach Raza, Shoftim 1	@דברים פרשת שופטים	NULL
Paaneach Raza, Shoftim 2	ובעזר לפניו יהיו דבריך מעטים, נתחיל סדר שופטים:	NULL
Paaneach Raza, Shoftim 3	שופטי"ם בגימטריא ע' סנהדרי"ם נסמכה פ' דיינין לג' רגלים לומר כי צריכים ג' שלא יהא ב"ד שקול (ד"א לומר דפני ה' הוא דלא יראה ריקם אבל בשופטים לא כן שלא תתן לדיין מאומה אם דרך שוחד, ולהורות על איסור הנותן אם בדרך שכר לומר שאסור ליקח שכר דינין שהתירו בקושי שכר בטלה:	NULL
Paaneach Raza, Shoftim 4	שח"ד אותיות חשד שאף מן החשד ומן הדומה לכיעור ירחק:	Deuteronomy 16:19
Paaneach Raza, Shoftim 5	ויסלף אותיות ויפסל שנפסל בכך, פי' רי"ח:	NULL
Paaneach Raza, Shoftim 6	לא תטע לך אשרה לפי הפשט ר"ל כי כן היו נוהגין למזבח הבעל:	Deuteronomy 16:21
Paaneach Raza, Shoftim 7	אשר"ה בגימט' דיי"ן שאינ"ו הגו"ן:	NULL
Paaneach Raza, Shoftim 8	לך מצבה כלומר לע"ז אבל לכבוד המת כיעקב שרי, בכור שור:	Deuteronomy 16:22
Paaneach Raza, Shoftim 9	אשר לא צויתי פי' להשתחוות להם אבל לה' או לאדם דרך כבוד כאברהם ויעקב צויתי, בכור שור:	Deuteronomy 17:3-4
Paaneach Raza, Shoftim 10	על פי שנים וגו' פי' שבדיינים כתיב אחרי רבים להטות, לכן הורה כאן דבזה לא אזלינן בתר רובא והכא שם עדות א' הוא, ג"ן:	NULL
Paaneach Raza, Shoftim 11	ד"א עצה טובה קמ"ל שיעיד ג' עדים באופן שאם ילך א' למדינת הים ישאר לו עדות שלימה, מרבי:	NULL
Paaneach Raza, Shoftim 12	ובער"ת הרע אותיות ערבו"ת או ותער"ב, שכל ישראל ערבים זל"ז, ולכן ובערת ולא תהא נתפס עוד בערבות:	Deuteronomy 17:7-8
Paaneach Raza, Shoftim 13	בין דם לדם בין דם זיבה ולידה ונדה:	NULL
Paaneach Raza, Shoftim 14	דברי ריבות השקאת סוטה שע"י ריב איש ואשתו, ועגלה ערופה שע"י ריב איש ורעהו, וטהרת מצורע שע"י מריבה ולשון הרע שהוציא:	Deuteronomy 17:8
Paaneach Raza, Shoftim 15	שום תשים עליך בגימט' שלשי"ם מעלו"ת, ובגימט' ל"ו מעלו"ת מיוחדי"ם למלכו"ת, וידוע כי לשבט יהודה ניתן המלכות כדכתיב לא יסור וגו', לכן יהודה בגימט' ל', ומילוי האותיות של יהודה בגימט' מלכו"ת בזה האופן, יו"ד ה"י דל"ת ה"י:	Deuteronomy 17:15
Paaneach Raza, Shoftim 16	לא תוכל לתת עליך איש נכרי, נכר"י בגימט' הורדו"ס דאמרינן בפ"ק דבבא בתרא דקטל כלהו רבנן ולא שייר אלא בבא בן בוטי:	Deuteronomy 17:15
Paaneach Raza, Shoftim 17	לבלתי רום לבבו וגו', זה הפסוק מתחיל בל' ומסיים בל' לומר כי המלכות נקנה בשלשים מעלות שהן הן המביאין לו רום לבב (ולכן הל' גבוה מכל האותיות ע"ש שהוא לגובה מעלות ומלכות וכן הי' מלך ראשון בישראל משכמו ולמעלה גבוה מכל העם ור"ת של הפסוק הזה עולים בגימט' תר"י, לומר שאם באולי ירום לבבו מכח יתר שאת ויתר עז מלכות על שניתן הוא בראש ישראל כדכתי' שום תשים עליך שלכן הרמז בר"ת על שהוא מלכם בראשם אז יתר ממקומו התעיף עיניך בו ואיננו ולא תכון מלכותו בידו, ופ"א אותיות הם בפ' הזה במנין כס"א שמכח כסא המלכות ג"כ יתגאה, אולי ע"ד רק הכסא אגדל, וכל אלה אמר לבלתי רום וגו' שיזהר מזה ולא יהא ניסת מכל אלה, ולכך מסיים הפסוק הוא ובניו בקרב ישראל שאם יהי' בקרב ובתוך הכלל שלא יחשבו עצמם נבדלים ונישאים וגבוהים מהם למעלה ראש אזי יאריכו ממלכתם):	Deuteronomy 17:20
Paaneach Raza, Shoftim 18	לבלתי רום לבבו הוא הטעם לכסף וזהב לא ירבה לו, כי כבר נתן טעם ללא ירבה לו סוסים ונשים ולכסף וזהב לא נתן, לכן מבאר עתה טעם גם לזה:	Deuteronomy 17:20
Paaneach Raza, Shoftim 19	ולבלתי סור מן המצוה הוא טעם נכון לספר תורה שיוצאת ונכנסת עמו, ג"ן:	Deuteronomy 17:20
Paaneach Raza, Shoftim 20	כי אתה בא אל הארץ וגו' לא תלמד לעשות כתועבות וגו' בדור המדבר שיצאו ממצרים כשהם גדולים ויודעים מנהג מצרים וגם היו מעותדים לבא לארץ כנען לולא חטא המרגלים בהם כתיב כמעשה ארץ מצרים וגו' וכמעשה ארץ כנען וגו' להזהירם על מעשה אלו ואלו, אבל באי הארץ שלא ידעו מעשה מצרים שיצאו משם קטנים לא הוצרך להזהירם כ"א על מעשה ארץ כנען, בכור שור:	Deuteronomy 18:9
Paaneach Raza, Shoftim 21	קוסם קסמים זה שרגילין לנחש בקסמין לקלפן מצד א' ומצד השני מניחין בלי קלוף, ובעת צאתו לדרך זורקין א' כלפי מעלה ואם יפול צד מחשוף הלבן כלפי מטה אומר זהו בדמיון איש ואח"כ זורק אחרת וכשיפול אז מחשוף הלבן כלפי מעלה אומר זהו אשה והוא לו לסימן טוב כשיבא דמיון איש תחלה ואח"כ דמיון אשה כבריאתם שיבטח בזה שיתקיים כבריאתו ולא יירט הדרך לנגדו בקורות וסכנות הנהוגות ואם יפלו בהפך אזי יחזור בו מלצאת לדרך שזהו סימן רע לו בניחושיו זהו קוסם קסמים:	Deuteronomy 18:10
Paaneach Raza, Shoftim 22	מעונן, זה שאוחז את העינים כפירש"י כי מעונן הוא לדרך זה לשון עין:	NULL
Paaneach Raza, Shoftim 23	ימכשף, כגון ההוא אתתא דהוה מהדרא למשקל עפרא מתותי כרעא דר' חנינא, ג"ן:	NULL
Paaneach Raza, Shoftim 24	מעונ"ן בגימט' אוחז"י העיני"ם:	NULL
Paaneach Raza, Shoftim 25	חובר חבר, ענין כפול הוא לומר בין חובר גדול שחובר דובים ואריות ובריות גדולות, בין חובר קטן כזיבורא ועקרבא:	Deuteronomy 18:11
Paaneach Raza, Shoftim 26	תמים תהי' תי"ו רבתי מאותיות גדולות לומר שכשהוא תמים מעלה עליו כאלו קיים כל התורה מאל"ף ועד תי"ו, זהו תי"ו רבתי שמשתרבבת להתפשט בכל האותיות עד א' (ד"א לומר שכ"כ תהי' תמים עד שיעשה רושם גדול שהכל יעידון ויגידון ויכירו בתמימותיך, כי התי"ו רבתי רמז שתתרברב ותיכתב במילואה בשלימות כזה, תי"ו, ואזי פירושה רושם כדכתיב והתוית תיו וגו', ועוד לומר שיגיע התמימות עד שתמות שתמסור נפשך אפילו על קדושת שמו ית', שהת' היא רמז לת' תמות כשהיא בקמץ לכן היא גדולה וניכרת היטב על שקידש שמו אף ברבים ובפרהסיא אפי' שהוא היותר גדול, ועוד לומר שיהא עומד בנסיון ויהא בדוק ובחון בתמימותו, לכן הוא רבתי, נבדקת ונבחנת מוחשת הרבה, ועוד כי תמי"ם הוא בהפך אותיות מתים, לומר בהפך ממ"ש לפניו בסמוך ודורש אל המתים הם הם הע"ז הקרוים מתים, ותי"ו בא במלת מת על שהוא סוף כל האותיות והוראה לסוף האדם למות הוא, ורמז אל ההעדר שהוא הוא ההעלם שמתעלם האדם והולך אל בית עולמו ועילומו, וכן הם הע"ז נעלמים ובעלי ההעדר והאפיסה לכן באה כאן ת' רבתי שידבק בתמימותו עם אל חי עולמים הפך העלם והעדר והפך מגדר המתים לכן תי"ו שלו רבתי שהוא מקיים מוחש ומורגש בחיים הפך דורש אל המתים הדבק בהעדר, ועוד ת' במילואה באופן זה, תא"ב, או תא"ו, הוא מלשון חשק ותאוה כדאיתא באותיות דרע"ק, והנה על הרוב איש התם ומתמם עם תמימים ימי חייו הם בצער ודכאות נפש כידוע, ורמז לו כאן שלא ישית לבו לזאת ואל יחוש לכך לצער עוה"ז ויהא תא"ב ומצפה לקבל טובות הגמול לעוה"ב כשיהיה עם ה' אלהיו, זהו תמים תהי' עכ"פ ואף שירע לך ע"י כך בעוה"ז, תשמח, דהלא רב טוב צפון לך עם ה' אלהיך, זהו ת' רבתי שתתרברב להתמלא במילוי לשון תאיבה ותאוה, זהו שאמר דוד יפרח בימיו צדיק ורוב שלום עד בלי ירח, ר"ל שהצדיק בעוד בימיו בעוה"ז יפרח, דהיינו כאילן ועץ כל פרי שטובתו אינה בפריחתו, דהפרח אינו אלא קדימה והכנה לפריו שיבא אח"כ כן הצדיק אל יחוש ויחוס עינו על שרע לו בעוה"ז, כי יפרח בימיו באופן שרוב שלום וטובתו הוא עדי עד כשיכלה הירח, דהיינו לע"ל ע"ד וחפרה הלבנה וגו', ונקט בעצם ראשונה הירח ולא החמה בעבור כי הצדיקים נמשלים ונקראים ע"ש הלבנה והיא גם היא זה דרכה ראשיתה מצער ואחריתה יסגא מאד ומתחדשת נעוריה):	Deuteronomy 18:13
Paaneach Raza, Shoftim 27	נביא מקרבך מאחיך כמוני וגו' כמונ"י בגימט' ענו כמשה:	Deuteronomy 18:15
Paaneach Raza, Shoftim 28	אנכ"י אדרו"ש מעמ"ו, עיין על סופי התיבות וסמיך לי' אך הנביא אשר יזיד וגו' ומת וגו' (ובא בס"ת כי גלוי הי' לפניו ית' ורמז שסופו לעמוד וסוף לדרוש מעמו ביום הדין הגדול והנורא), והתיבות אשר אציג לפניך כאן כ"א בגימט' כמספר שמו, דהיינו אלה"י נכ"ר, ומחי"ר כל"ב, הב"ל ורי"ק, ור"ת של "ועל "שפם "יעטה (ובכאן נרמז בר"ת מפני שבכאן ידבר הפסוק בטמא ונגוע וזה הוא ראש לכל הטמאים ולכל הנגעים שעברו עלינו, כי כל טצדקי דעדו עלן כולם כאין נגדו וק"ל, והרמז כאן למפרע בר"ת אלו מפני שהסיג אחו"ר את הבריות מאחר"י הש"י, וגם נהפו"ך הוא, והפ"ך הקערה על פיה, והשיב הדת אחו"ר, גם כי סבלנו ועודנו סובלים רשעו עד כה למפרע מאז הי' על האדמה, ורבים פרועי"ם היו עלינו כי פרע אותם לשמצה בקמינו, ממרום יערה רוח אלהי אבותינו ליקח את נקמתינו):	Deuteronomy 18:19-20
Paaneach Raza, Shoftim 29	ובער"ת הרע וגו' וסמיך לי' כי תצא וגו', לומר כי בזכות האבידך את הרשעים ואת הרשע תצא למלחמה ותנצח:	Deuteronomy 19:19-20
Paaneach Raza, Shoftim 30	לא תשחית וגו' כי אדם עץ השדה פי' כי משמש בלשון אלא כלומר לא תשחית עץ מאכל אלא שאדם עץ השדה, כלומר עץ השדה שב"א יוכלו לבא בו מפניך במצור אותו תוכל להכרית ולהשחית אע"פ שהוא עץ מאכל ולא זולת זה, רבינו שמואל:	Deuteronomy 20:19
Paaneach Raza, Shoftim 31	כי ימצא חלל, נכתבה פ' עגלה ערופה בין שתי פרשיות כי תצא למלחמה מפני שע"י מלחמות ימצאו חללים שלא נודע הורגיהם:	NULL
Paaneach Raza, Shoftim 32	אל נחל איתן שהוא קשה לרמוז על דבר קשה דהיינו שאם לא ימצא ההורג תולעים יוצאים מן הנהרג ונכנסים בגופו של הורג וממיתים אותו כדאיתא בירושלמי, והרמז מ"ש ואתה" תבער" הדם" הנקי" ס"ת רימ"ה בערבוב, מהר"ן בר נטרונאי:	Deuteronomy 21:4
Paaneach Raza, Shoftim 33	(ודוקא לבסוף אם לא נמצא ההורג יהי' עירוב התולעים הזה כך שיתערבו מהנהרג להורג כנזכר, לכן בא רמז בס"ת ובערבוב אותיות שלא כסדר, ועוד נרמז בסוף ובעירבוב מפני שסוף אנוש ותקותו רימה ולריבויים שיבאו גדודים וצמודים לאכול בשר וגידים של המת וככל הנזכר בפייט אזכרה יום מותי שיסד ר' שלמה בן גבירול ז"ל, מתערבבים ושורצים ורומשים שם בסיבוך ועירוב), ובס' שכל טוב אומר שמהעגלה תולעים באים על הרוצח (וגם לזה רמז בפסוק בייתור את העגלה שכתוב שנית א"ת העגל"ה בגימט' תולע"ה ב"א, או התול"ע ב"א שמאת העגלה יבאו, ורמז עוד במה שמספר את העגלה הוא ג' יתר על מספר תולעה לומר כמובן אות ג', כלומר שתולעה מהעגלה הוא גמולו ופרעונו אשר ישוב בראשו במדה נכונה באשר מהראוי הי' חייב הוא למות והעגלה הומתה במקומו לכן תיקח גם העגלה נקמתה ממנו, ולדעתי תרווייהו אתנהו דהיינו כי ימצא אח"כ ויעשו בו כמשפט יצאו מהעגלה או אם לא ימצא כלל, אבל אם אין עושין עגלה כלל יצאו מהנהרג כדי שיקח הנהרג נקמתו):	NULL
Paaneach Raza, Shoftim 34	ידינו לא שפכה, כתיב בה"י כלומר ה' אצבעות לא שפכו דם הנפש שי"ל ה' שמות (ולפי הדרך הזה כשתרמוז הה"י על ה' אצבעות יותר נראה לומר שהרמז כלשון בני אדם כלומר אפי' באצבע קטנה לא נגענו בו, אבל לי נראה לומר בזה כי נודע שבשפיכות דם סתמא בנוהג שבעולם על הרוב לא ימיתנו כ"א בשלוט בו בשתי ידיו בכח עצום ורב כמ"ש בכ"מ ענין הרציחה בלשון רבים של שתי ידים כדכתיב לקחת את דמי אחיך מידך רק שהיו"ד תנינא היא חסרה שם מטעם לרמוז שידיו איבדו הדם הוא הנפש שיש בו עשרה דברים רוחנים בשותפות הקב"ה ואב ואם שזהו הטעם הראשון שנזכר שפיכות דם בתורה אצל קין ראוי הי' לעורר בו רמז זה יותר מבמקום אחר המאוחר, אבל ידיך קרינן לי' וכתיב נמי ידים שופכות דם נקי, ידיכם דמים מלאו, הכל כאשר לכל בלשון ידים רבים וכן כולם זולת בגואל הדם שנמצא בכ"מ יד לשון יחידה ליד גואל הדם וגו' וכיוצא, מפני כי לרוב חימום הלב שבו עליו להתנקם ימיתנו בכונה רצוי' ואמיץ כח אף בידו אחת ואפי' בשמאל כלשון סתם יד בכ"מ מכח שהוא מתחרה ומתגרה הרבה וכ"ה ביאור או באיבה הכהו בידו וימות וכיו"ב בכ"מ דמיירי בעברת זדון רב וחמום גדול, אבל בסתמא אין שייך אלא בב' ידים כנזכר, לכן כאן הכתיב הוא שפכה בה"י הנקבה לשון יד א' על שלא הרגוהו באיבה וזדון, והקרי הוא שפכו בלשון רבים של שתי ידים כלומר להתנצל שלא הרגוהו אף בקרי והזדמן בסתם הריגה, ולכן דוקא הקרי שפכו והכתיב שפכה ולא איפכא, מלשון נופל על לשון מקרה קרה, כי גם לשון קרוא מקרא וקריאת התורה הוא לשון קרה מקרה, בעבור שהפסוקים בעצם קריאתה אין בהם כונה ועומק אלא כקורא בתורה בדרך מקרה בעלמא, ועוד שיהי' הקרי רבותא יותר, שאפי' במקרה בב' ידים לא הרגוהו, והנה הוא בדרך לא זו אף זו כי ס"ל יש אם למקרא, שהקרי הוא עיקר, לכן בו צריך לרמוז הרבותא יותר, דאם הי' זה נרמז במסורת הי' הדרש הזה ראשון, ורמז יד אחת שהי' נרמז בקרי הי' בא אחריו כיון שהוא עיקר טפי ממסורת, וא"כ הי' בדרך זו ואצ"ל זו, ועוד מתוך דרך הנזכר באה ה"י במלת שפכה ללשון יד אחת לומר אף מגע יד בעלמא לא הי' לנו בזה גם בזולת עצם השפיכה דהיינו כאמרם לא פטרנוהו בלא לויה אשר בנוהג שבעולם בהפטרם זמ"ז יתנו יד לנטילת רשות ולפטירה בדביקות וקירוב הלבבות, זהו לא שפכה לשון יחידה שאפי' גרם התלוי ביד אחת ומגע נתינתה בעלמא לא עשינו דהיינו שבאמת פטרנוהו בלויה ונתינת יד):	Deuteronomy 21:7
Paaneach Raza, Shoftim 35	כפר לעמך וגו'. אומר במדרש אלו החיים אשר פדית ה' אלו המתים הנפדין בממון החיים ומכאן סמוך לשנהגו ליתן בעד הזכרת נשמות ולהזכירם, ג"ן:	Deuteronomy 21:8
Paaneach Raza, Shoftim 36	ונכפר להם וגו', אמר רבינו בכור שור שכל היגיעה הזאת צוה הש"י לשיהא פרסום וקול גדול בדבר באוושא דמלתא שמתוך כך יבאו מכירים רחוקים ויעידו ויגידו ולא תהא אשתו עגונה, שכל עדים שיאמרו מכירים אנו שהוא זה ודאי מועיל אף לאח"ז רב ומה שאין מעידין אלא על פרצוף פנים עם החוטם היינו כשאומרים מעידין אנו על פרצופו שהוא כו"כ והם אינם רואים ההרוג והרואים ידמו מכח עדותם שהוא זה כההוא דטבע בדגלת וכו', ג"ן:	Deuteronomy 21:8-9
Paaneach Raza, Shoftim 37	אתה תבער וגו' כי תעשה וגו' פי' אם תעשה כ"ז כמצווה וכהלכתו אז תבער דם הנקי, כי ע"י העיירות הבאות למדוד יוכר ויוודע הרוצח (ואולי יאמר לענין תולעים שיוצאים מן העגלה כנזכר שיאמר ואתה הוא המבער דם הנקי כי תעשה הישר בעיני ה' ככל הכתוב בפרשה כי מן העגלה יצאו וכו' ויתבער הדם על ידך אף אם לא ימצא ההורג, ולאפוקי אם לא תעשה כזאת אז יתבער ממילא בידי שמים שיצאו תולעים מהנהרג עצמו ולא אתה תבער וכנזכר לעיל):	Deuteronomy 21:9
Paaneach Raza, Ki Teitzei 1	@דברים פרשת כי תצא	NULL
Paaneach Raza, Ki Teitzei 2	ובעזר אשר דוד עבדו פוצה, נתחיל סדר כי תצא:	NULL
Paaneach Raza, Ki Teitzei 3	כי תצא נסמך לכי תעשה הישר לפי שדברה תורה נגד יצה"ר והתירה יפ"ת, לכן כשיצאו לקחו הטובים והישרים שבהם, (ד"א שאע"פ שבמלחמת הרשות הכתוב מדבר אעפ"כ תעשה הישר בעיני ה' כי תצא למלחמה ולא תאמר שאין דעת המקום נוחה בזה, ד"א שתעשה הישר בעיני ה' כי תצא אתה להם להלחם בם חוץ לארצך, ולא תניחם לבא עליך לארצך וירויח לך וגם לא תשחית את ארצך, ד"א שאם תרצה לצאת צריך אתה לעשות הישר בעיני ה' שלא ירך לבך כדכתיב מי האיש הירא וגו' ילך וישוב וגו' לר"י הגלילי שפי' על יראת לב מעבירה ולר' עקיבא שמפרשו כמשמעו שא"י לראות חרב שלופה נמי יאמר שעכ"פ תעשה נחת ליוצרך כי תצא מיהת אף שתשוב אח"כ לביתך מהכרזת השוטרים, ובזה ידוקדק היטב אומרו כי תצא ולא כי תלחם, גם זהו דקדוק לשון הכתוב לעיל בפרשת שופטים בכלהו הכרזות בענין הכפל לשון ילך וישוב וגו', ולא סגי לי' בחדא מינייהו, דהכי קאמר עכ"פ ילך למלחמה לפני אחיו ולא ימס לבב העם בהסוגו אחור מלצאת כלל, ואח"כ ישוב לביתו מכל א' מהטעמים הנזכרים לעיל יהי' איזה שיהי', דהשתא לא ימס לב העם שלא יחשדוהו שמרוך לבב הוא שב, דאל"כ למה הלך מתחלה, אלא ודאי שחוזר מטעם אשר בנה או נטע או אירס וכן אף בחוזר מרוך לבב באמת יחשבו עליו אחת מהנך סבות, אבל אם הי' נשאר מתחלה בביתו אף אם אין זה מרוך לבבו הן לא יאמינו וימס לבבם, זהו פירושו לעיל, והטעם מוכח כן, כי ילך בא בכולם בטעם טפחא לנוח שם בנגינה ולהכריתו מוישוב לביתו, ואל תטעה לומר הלא הענין מיירי כשהם כבר במלחמה כדכתיב כי תצא וגו' וראית סוס ורכב וגו' דאף אם נודה בזה יוכל הכתוב לרמוז כאן אמתחלה, אבל באמת מיירי שמכריזין כך קודם צאתם מגבול הארץ כפירש"י לעיל בסמוך על והי' כקרבכם אל המלחמה, וזה תעשה הישר אף אם אינך אלא יוצא, שמצווה על היציאה עכ"פ אף אם ישוב אח"כ ולכן נמצאת אות צד"י של כי תצא ברוב הספרים יוצאת הרבה בגובה למעלה מהתי"ו והאלו"ף מתיקון סופרים כותבי ספרי תורה לומר כי צדקה תחשב לו אף היציאה לבד זהו יציאת אות צד"י למעלה שאם הוא צדיק ועושה רצון קונו יצא לפחות, ועוד להורות שאל יצאו אלא צדיקים, ולכן ת' לפניה וא' לאחריה שזה היוצא למלחמה ראוי להיות צדיק בכל התורה מתי"ו עד אלו"ף לכך, ועוד ירצה במה שהאות הזה יוצא הרבה בגובה וניכרת להורות כי יציאת צדיק למלחמה עושה רושם ונוצחים בזכותו):	NULL
Paaneach Raza, Ki Teitzei 4	יפת תואר, לשון פתוי שמתפתה מתוארה, יפת אותיות פת"י שמשיבה חכמים אחור ודעתם תסכל:	NULL
Paaneach Raza, Ki Teitzei 5	ושלחתה לנפשה פי' ואם חלתה ממתין לה עד שתבריא ותחזור נפשיה, ושלחת"ה אותיות ושחלת"ה פי' רי"ח:	Deuteronomy 21:14
Paaneach Raza, Ki Teitzei 6	לשניאה, כתיב ביו"ד ולא לשנואה בוי"ו שיהי' אותיות לי שנאה, כלומר המקום ב"ה אומר שהיא שנואה בעיניו ושנואים מעשיה (ויש לי לומר דלכך באה יו"ד תמורת הוי"ו כדי שיהי' אותיות י"ה בתיבה זו לומר כי הוא ית' שהוטל שמו שם השלום הוא סוד שם י"ה בין איש לאשה להטיל ביניהם שלום הוא המסבב גם הדבר הזה מפני השלום, אף אם היא שנואה לשמים וכ"ש אם הוא כפשוטו וירא כי שנואה היא ויפתח את רחמה תחלה שעי"כ יאהבה אשה וילוה אליה ובפרט שכיון שידע שכל אשר ימצא לא יגיע לבנה פי שנים ממנו שיאהבה, ולכן בא טעם תביר תחת מלת והי' להמשיכה לעצמה מוכרתה קצת מבן הבכור לשניאה הכתוב אחריה, לומר שמלת והי' הוא כמו גזירה ובשורה כאלו ודאי יהי' כן, וכמו והי' אם לא חפצת דבסמוך שפירש"י בו מבשרך שסופך לשנאתה כן ג"כ כאן אל ההפך שידבק בה, וליותר הרמז לזה בא ג"כ היו"ד כדי שיהי' לשניא"ה אותיות ל"ן אש"ה, כי עי"כ יאהבה ובין שדיה ילין):	Deuteronomy 21:15
Paaneach Raza, Ki Teitzei 7	אשר" ימצא" לו" כי" ס"ת אותיות ראוי, לומר שאינו נוטל פי שנים בראוי, הר"ר אליעזר:	Deuteronomy 21:16
Paaneach Raza, Ki Teitzei 8	(ויש לפקפק מהיכן רמז שלא יטול, דשמא הרמז הוא שיטול בראוי כפשטי' דקרא דמיירי במה שיטול, ונראה מכח דמלת בכל מיותרת, דהוי מצי למכתב באשר ימצא לו, אלא שכתב כן כדי לסמוך אות ל' של בכל לאות א' של אשר ויהיו נקראים יחד לרמז למלת ל"א שלא יטול בראוי, וכאלו אמר לתת לו פי שנים במצוי לא בראוי, ואותיות ראוי באו בס"ת לפי שמיירי במה שלבסוף ראוי לבא):	NULL
Paaneach Raza, Ki Teitzei 9	כי יהי' לאיש בן סורר רמז כאן מספר שלשים ג"פ רצופים, כ"י הוא שלשים, יהי"ה הוא שלשים, ל' של לאיש הוא שלשים לומר כי כל ימי חיובו שיכול ליעשות בן סורר אינו אלא ג' חדשים משהביא שתי שערות כמ"ש רז"ל הקיף התחתון אע"פ שלא מלו לי' ג' חדשים מלו לי' ג' חדשים אע"פ שלא הוקף התחתון אינו נעשה בן סורר ומורה:	NULL
Paaneach Raza, Ki Teitzei 10	בן סורר ומורה פירש"י ע"ש סופו וכו', וקשה והא אף אם עתה הי' מלסטם לא הי' חייב רק חנק הקל ועתה על העתיד יהא נדון בחמורה וי"ל דסופו ללסטם בין בחול בין בשבת ויהי' חייב גם על חילול שבת דהיינו סקילה ומחויב ב' מיתות נדון בחמורה, מפי הר"ר שלמה:	NULL
Paaneach Raza, Ki Teitzei 11	ומרה, ומרה כתיב חסר ו' לדורשו לשון מרה כלענה לומר כי מרה תהי' לו באחרונה, כלומר שנדון ע"ש סופו, ר"י חסיד:	NULL
Paaneach Raza, Ki Teitzei 12	וקשה למ"ד בן סורר לא הי' ולא נברא ולא עתיד להיות למה נכתב, וי"ל ללמדנו שב"ד מכין ועונשין אף שלא מה"ד אם השעה צריכה לכך:	NULL
Paaneach Raza, Ki Teitzei 13	וכ"י יהי"ה באי"ש חט"א וגו' בגימט' אבשלו"ם:	Deuteronomy 21:17
Paaneach Raza, Ki Teitzei 14	לא תלין נבלתו וגו' כי קללת אלהים וגו', פי' מפני שגם קללת אלהים דינו שיהא נתלה דהיינו מגדף שדינו שנסקל ונתלה, לכן לא תלין כל נתלה כי יאמרו שהי' זה מגדף וזהו גנאי למלך, כי כל הסוטר למלך או תולש בזקנו אף שנעשה בו דין כבר מ"מ זכרון סרחונו הוא גנאי למלך תמיד, וי"מ דכך הוא נתינת טעם שהרואים יכמרו רחמיהם על הנתלה ויקללו הדיין שדנו לתלייה ויעברו על אלהים לא תקלל לכן לא תלין, זהו כי קללת אלהים תלוי:	NULL
Paaneach Raza, Ki Teitzei 15	לא תלין, וקשה למה הניחו את בני שאול ויהונתן נתלין מתחלת קציר עד ניתך עליהם מים, וי"ל דכאן כתיב ולא תטמא וגו' סמוך ללא תלין לומר שהטעם בלא תלין הוא משום ולא תטמא וגו' כלומר שלא ינוח עליו חיה או עוף ויוליכו ממנו לאיזה טהרה ויטמאוה והתם לא הי' לחוש לזה דכתיב שם ותקח רצפה בת איה השק וגו' ולא נתנה עוף השמים לנוח וגו', בכור שור:	Deuteronomy 21:18-19
Paaneach Raza, Ki Teitzei 16	על העץ כי קבור וגו' מכאן שהכל נקבר עמו פי' רי"ח:	NULL
Paaneach Raza, Ki Teitzei 17	לא תראה את שור אחיך וגו' נסמך לשלפניו לומר כי מי שהומת בב"ד ושורו או שיו נדחים השב תשיבם וגו' כלומר שמכאן שהרוגי ב"ד נכסיהם ליורשיהם דלא כחקי הגוים בהרוגי מלכות ובתי דיניהם שפוסקים נכסיהם למלכות, פי' רי"ח:	Deuteronomy 21:23
Paaneach Raza, Ki Teitzei 18	והתעלמ"ת מה"ם בגימט' משו"ם כבו"ד בריו"ת דהיינו מה שדרשו פעמים שאתה מתעלם כגון זקן ואינו לפי כבודו:	Deuteronomy 22:1
Paaneach Raza, Ki Teitzei 19	יקר"א ק"ן בגימט' פר"ט למזומ"ן והארכת ימים להעוף, והארכ"ת ימי"ם בגימט' בעול"ם שכל"ו ארו"ך:	NULL
Paaneach Raza, Ki Teitzei 20	כלאים" פן" תקדש" המלאה" ס"ת מנשה. כי מנשה עשה כלאים במה שהעמיד צלם בהיכל לכן נשרף, כמו פן תקדש שפי' שטעון שריפה כדדרשינן, תקדש תוקד אש, הר"ר אליעזר:	Deuteronomy 22:9
Paaneach Raza, Ki Teitzei 21	(ורמז בס"ת דוקא כי הורה אז הפסוק שסופו לעמוד ולעשות כך):	NULL
Paaneach Raza, Ki Teitzei 22	כי יפול הנופל הנפל חסר כתיב שיהא משמע לשון עבר כדאמר גבי כלב כבר נד ולד:	NULL
Paaneach Raza, Ki Teitzei 23	לא תחרוש בשור ובחמור וגו' כדי שלא ירגיל להרביעם זע"ז, בכור שור:	NULL
Paaneach Raza, Ki Teitzei 24	ואני שמעתי שזה מעלה גרה וזה לא יגר וחושב שהלה אוכל ויש לו צער ב"ח:	Deuteronomy 22:14
Paaneach Raza, Ki Teitzei 25	לא תלבש שעטנז משום דבגדי כהונה היו מכלאים ואין להשתמש בשרביטו של מלך לכן גדילים תעשה לך וגו' שכיון שגם הוא למצוה מותר תכלת בסדין:	Deuteronomy 24:19
Paaneach Raza, Ki Teitzei 26	כי יקח איש וגו', תימה למה לא מברכין ברכת אירוסין קודם קידושין הא כל הברכות צ"ל עובר לעשייתן, וי"ל דשמא יחזרו בהם קודם הקידושין ויהי' ברכה לבטלה, א"נ דברכה זו אינה דומה לשאר ברכות דלא קאי אקידושין דידי' דהא לא אמרינן וציונו לקדש האשה אלא וציונו על העריות דמשמע עריות דעלמא, מהר"ר חיים:	NULL
Paaneach Raza, Ki Teitzei 27	ותימה למה באמת בשעת קידושין לא מברכין לקדש את האשה, לוי:	NULL
Paaneach Raza, Ki Teitzei 28	(ול"נ משום דאינו אלא התחלת המצוה ואין בקידושין לבדן מצוה שלימה כי חופה וקידושין גם יחד הם מצוה אחת):	NULL
Paaneach Raza, Ki Teitzei 29	וחפרת וכסית וגו', וקשה הא נקרא המן לחם אבירים על שנבלע באברים וא"כ לא היו צריכים למצוה זו, וי"ל דהוצרכו לה אמאכל שקנאו מתגרי האומות, מהר"ר חיים:	NULL
Paaneach Raza, Ki Teitzei 30	(ולק"מ דעכ"פ הוצרכו אאחר כניסתם לארץ ואם לא יצטוו עכשיו קרוב למיתת משה, אימתי:	NULL
Paaneach Raza, Ki Teitzei 31	ספר כריתת ב"פ כתיב ובכל פעם חסר ו' הרי חסרון ב' ווי"ן הם י"ב כמספר גט לרמז על י"ב שיטין שבגט:	Deuteronomy 25:3
Paaneach Raza, Ki Teitzei 32	לא תחסום וסמיך לי' כי ישבו אחים וגו' מלמד ליבמה שנפלה לפני מוכת שחין שאין חוסמין אותה מלומר לא בעינא לי' לאפוקי דנימא יבא עשה דיבמה יבא עליה וידחה ל"ת דלא תחסום, לכן סמכן, מהר"ר חיים:	NULL
Paaneach Raza, Ki Teitzei 33	וחלצה נעלו וגו' וירקה, למה קדמה חליצה לרקיקה, משום דמתחלה עושה כנופלת לרגליו להתחנן ולבקש שישאנה ושרוצה להיות כאחת משפחותיו לעמוד ולשרת ולחלוץ את מנעליו, ואח"כ מכיון שאומר לא חפצתי לקחתה תריק לפניו כאומרת גם אתה בזוי ושפל בעיני ומאוס עלי כרוק הזה וגם אני איני חפצה בך, ר' מנחם בר נטרונאי, ומשלכת את נעלו להלאה כאומרת לא אנעלך ולא אשרת לך, בכור שור:	Deuteronomy 25:9
Paaneach Raza, Ki Teitzei 34	אמר לי מהר"ר חיים מעשה בימי רבינו שמחה ביבמה אחת עשירה ומיוחסת שרצה יבם ליבמה בע"כ ייעץ לה ר' שמחה שתרוק בפניו אם תראהו ותפסלנו בזה מלייבם וכן עשתה ופסלה ר' שמחה מלהתייבם והביא ראי' לפסק זה מדבר הלכה (ואני רואה הוכחה ורמז לזה בפסוק במ"ש אשר לא יבנה וגו' בלשון עתיד כמו שדייקינן נמי מיני' דחליצה פוסלת כ"ש דקאי ארקיקה הסמוכה לזה בפסוק יותר מחליצה לומר שיהי' הרוק פוסל ולא יהא בונה ולא יוכל לבנות):	NULL
Paaneach Raza, Ki Teitzei 35	ונקרא שמו וגו', כלומר שהכל קוראין לו כך, כאלו אומרים מי שנעלו חלוץ ואין לו מי שינעלו מבזין אותו כך ובזה תתיישב דעתה, בכור שור:	Deuteronomy 25:10
Paaneach Raza, Ki Teitzei 36	כל עושה עול וסמיך לי' זכור את אשר עשה וגו' כלומר ראה לכתוב על ספר כל העול שעשה לך עמלק דהיינו המסופר אחרי כן כדי שיראו הכל למה המתי ומחיתי אותו וכאשר כתיב כתוב זאת זכרון בספר:	Deuteronomy 25:16-17
Paaneach Raza, Ki Tavo 1	@דברים פרשת כי תבוא	NULL
Paaneach Raza, Ki Tavo 2	ובעזר רמה בים סוס ורוכבו, נתחיל סדר כי תבא:	NULL
Paaneach Raza, Ki Tavo 3	והיה כי תבא וגו' סמוך ללא תשכח דלעיל, דמקודם ביאה לארץ אינם מצווים על מחיית זכר עמלק:	Deuteronomy 28:8
Paaneach Raza, Ki Tavo 4	אשר נשבע ה' לאבותינו מכאן שהגר מביא ואינו קורא שא"י לומר לאבותינו, ותימה א"כ איך יתפלל הא איכא בנוסח התפלה אלהינו ואלהי אבותינו וי"ל דבתפלה סומכין על הירושלמי שכתב שמכח אברהם אשר כולם נקראים על שמו ושלכך נקרא הוא אב המון גוים יכולין לאומרו, ג"ן:	Deuteronomy 28:11
Paaneach Raza, Ki Tavo 5	(ואין נראה דאיך יאמרו לאבותינו לשון רבים לכן נראה לומר דבתפלה יוכל להתפרש אאדם ונח שכל האומות יצאו מהם ואין מוכרח דליקו דוקא אאברהם יצחק ויעקב המפורשים ואדרבה שכיון שהם מפורשים אח"כ יותר יש לנו לומר דמתחלה לאו עלייהו קאמר והוי כאלו אומר אלהי אדם ונח אלהי אברהם וכו' לכן יכולין שפיר לאומרו. אבל שבועת נתינת הארץ לא היתה אלא לאלו ג' אבות לכן לא יאמרו נשבעת לאבותינו):	NULL
Paaneach Raza, Ki Tavo 6	ארמי אובד אבי וקשה למה לא יזכיר זכות אברהם ויצחק כמו של יעקב, וי"ל שיעקב נקרא ראשית כדכתיב קודש ישראל לה' ראשית תבואתו, לכן על נכון יזכר שמו על הבאת ראשית בפרטות, הר"ר אהרן:	NULL
Paaneach Raza, Ki Tavo 7	לא אכלתי באוני ממנו פי' בגזל ובחמס כמו וידיו תשבנה אונו דאיוב:	NULL
Paaneach Raza, Ki Tavo 8	ולא נתתי ממנו למת פירש"י לעשות לו ארון ותכריכים, ותימה דבפרק הערל דרשינן מיני' סיכה ופריך התם ואימא ליקח לו ארון ותכריכין ומשני כתיב ממנו דבר הניתן מגופו למת משמע א"כ הרי לא מיירי קרא בהכי, מהר"ר יעקב:	NULL
Paaneach Raza, Ki Tavo 9	(וי"ל דסוגיא דהתם בעי למימר דדלמא דוקא לארון ותכריכין קמיירי קרא ולא בסיכה ומשני מכח ממנו דגם בסיכה מיירי, אבל לעולם גם ליקח ארון ותכריכין מיירי עכ"פ מפשטי' דקרא, והנה אחר כתבי זאת מצאתי שם שתירצו התוס' בזה והכריחוהו מכח מס' מעשר שני דדריש שם קרא בהדיא בלוקח ארון ותכריכין, והמדקדק בהערל בדברי רש"י יבין וידע ברור שגם רש"י רמז כן בדעת המקשה שכונתו ואימא להאי לחודא אתי ולא לסיכה):	NULL
Paaneach Raza, Ki Tavo 10	את ה' האמרת היום וגו', י"מ לשון חילוף שהחלפת בו כל אלהי הגוים ובחרת בו, וכן וה' האמירך שהחליף בך כל האומות, וכמו יתאמרו כל פועלי און, שפי' שמחליפין דבריהם ואינם עומדים בדיבורם, וי"מ לשון אמירה שאמרת לקבלו לאלוה, וי"מ לשון גבהות לשון אמיר וענף כמו שנים שלשה גרגרים בראש אמיר שאתה מגביהו ומרוממו על כל אלהים והוא מגביה אותך על כל העמים, בכור שור:	NULL
Paaneach Raza, Ki Tavo 11	ולתתך עליון על כל הגוים אש"ר עש"ה בגימט' שבעי"ם אומו"ת:	NULL
Paaneach Raza, Ki Tavo 12	וכתבת על האבנים וגו' קצת תימה איך הי' כותב כל התורה בשבעים לשון על י"ב אבנים (עיין בדברי הרמב"ן) ארור וגו' י"ב קללות לי"ב שבטים וכולן על שבסתר דעל הגלויות הב"ד יענישוהו מיתה ולכך לא קאמר השוכב את אשת רעהו, דאין זה סתר דמה לו ליכנס לבית רעהו או היא לביתו אם לא לניאוף לאפוקי כל הני שייכין בביתו:	Deuteronomy 28:21
Paaneach Raza, Ki Tavo 13	ברוך אתה בבואך וגו', משה הקדים הביאה ליציאה משום שהיו באים לא"י, ואלו דוד שינה ואמר ה' ישמור צאתך וגו' שהקדים היציאה, מפני שעל עולי רגלים דיבר שיוצאים מביתם ואח"כ חוזרים:	NULL
Paaneach Raza, Ki Tavo 14	והלוית גוים רבים וגו' ושלא תדאג איך אהא כופה אותם לפרעון לכן אמר ונתנך ה' לראש וע"כ ילוו ויפרעו:	NULL
Paaneach Raza, Ki Tavo 15	והי' אם לא תשמעו וגו', בתוכחה ראשונה אשר בת"כ יש מ"ט קללות ובשניה הזאת צ"ח קללות, הרי ק"ן קללות חסר ג' ועליהם אמר ישעי' ע"ל מ"ה תכו עוד תוסיפו סרה, כלומר כמספר ע"ל מ"ה ועוד נוסף עליהם, כלומר לכל תוכחה אחת יתר עליהם, דהיינו שתים יתרות על מספר ע"ל מ"ה תכו ואעפ"כ תוסיפו סרה:	NULL
Paaneach Raza, Ki Tavo 16	אשר לא כתובה, שהיו השרים לוקחים בחורי ישראל הנחמדים מפז והמגנים את החמה ביופיין וקושרים אותם בכרעי מטתם ומשמשין עם נשיהם לפניהם כדי שיראו הנשים בשעת תשמיש ויחמנה להם ויולידו כמותם, בכור שור:	NULL
Paaneach Raza, Ki Tavo 17	וי"מ אשר לא כתובה בכל אותן עלילות קשות של שקר הידועות שמעלילין עלינו האומות וק"ל:	NULL
Paaneach Raza, Ki Tavo 18	והי' כאשר שש וגו' כן ישיש וגו', ישיש לא נאמר שהוא ית' אינו שש בפורענותם אבל אחרים משיש, ובדברים האלה יש רמז לקץ גלותינו והוא מכוון עם הכתוב בדניאל, ומעת הוסר התמיד לתת שקוץ שומם אלף ומאתים ותשעים דזהו שכתוב כאן כאשר שש ה' עליכם להטיב אתכם ולהרבות אתכם כן ישיש וגו' כלומר שתגלו כמנין השנים שהטיב אתכם דהיינו להרבות אתכם זה זמן היותכם במצרים דכתיב בי' ויפרו וירבו וגו' שהוא ת' שנה, ולהטיב אתכם זה זמן המדבר וא"י עד שחרב בית ראשון שהיתה שכינתו בקרבכם שהוא תת"צ שנה, מיציאת מצרים עד בנין הבית ת"ף כדכתיב ויהי בארבע מאות ושמונים וגו' בנה שלמה וגו', ות"י שנה שעמד הבית הרי בין הכל עם ת' של מצרים אלף ר"צ שנים כמספר הנזכר בפסוק שבדניאל הנזכר, וכן הוא מכוון עם הפ' למועד מועדים וחצי שפי' כך שבזה הפסוק יחשוב מצרים ת"ל שנה כפסוק ומושב ב"י וגו' ארבע מאות ושלשים וגו'. וע"ז קאמר מועד מועדים וגו', מועד כלומר מועד צאתך ממצרים, זמן אותו הגלות תקח מועדים, כלומר כפול דהיינו תת"ס שנה, כלומר שממועדים ר"ל מב"פ כזה תעשה מועד וחשבון זמן אחר, ואח"כ וחצי, כלומר ועוד חצי הכפל הזה שהוא ת"ל שיהי' בין הכל אלף ר"צ, וה"ה דהמ"ל ג"פ ת"ל אלא שבא לסתום הדברים, וכן פי' של עידן ועידנין ופלג עידן, וכן כונת הושע בפסוק וענתה שמה כימי נעוריה וכיום עלותה מארץ מצרים, וענתה לשון מעון, שתדור ותגור בגלות האחרון כימי גלות נעוריה, כלומר בגלות ראשון שהוא של מצרים דהיינו ת' שנה, וכיום עלותה מארץ מצרים, כלומר כזמן שמיציאה עד החורבן בית ראשון שכולו זמן עלייה עד שבאה לגלות שני דהיינו בין הכל אלף ר"צ כנז', הרי שהקץ רמוז בתורה ושנוי בנביאים ומשולש בכתובים, והקץ האחר שבדניאל דכתיב אשרי המחכה וגו' נרמז בוילך כאשר נבאר שם בעז"ה. הנה ההפרש שביניהם הוא מ"ה שנים, כי לסוף אלף ומאתים ותשעים יבא הגואל ב"ב ואחר מ"ה לביאתו יהי' נכבש כל העולם תחת י"ד ע"ם ה' אל"ה ותשקוט כל הארץ, ולכך נאמר שם אשרי וגו', אבל לא נודע מהיכן מתחיל המספר לשנדע מתי יכלה, כאשר קרה בשל מצרים שנאמר לאברהם בברית בין הבתרים ד' מאות שנה ואז הי' הוא בן ע' שנה דהיינו ל' שנה קודם לידת יצחק, והנה יש שמנאום מאותה שעה וטעו בה בל' שנים יצאו בני אפרים ונהרגו ויש מי שמנאו מירידתם למצרים, ויש מהתחלת השיעבוד, וכולם טעו ולא נודע האמת עד שיצאו שאז ידעו למפרע שמלידת יצחק התחיל החשבון וכן בגלות בבל שכתוב לפי מלאת לבבל שבעים שנה אפקוד וגו', חשב בלשצר וטעה, אחשוורוש וטעה, דניאל וטעה, כדאיתא במגילה ככה בגלותינו הארוך הזה שמא החשבון מתחיל משעת ביטול התמיד בימי הורקנוס ואריסתובלוס שהעלו להם חזיר כדאיתא בסוטה והיינו מעת הוסר התמיד או שמא משמלך הורדוס, שלא הי' ראוי למלוך על ישראל, או שמא לאיזה דבר מאוחר משעה שגלו, ולעת קץ כשיבא משיח במהרה בימינו יוודע מהיכן התחיל כאשר אירע במצרים, והוא שכתוב בדניאל עד עת קץ יתבררו ויתלבנו, פי' שהדברים יתלבנו ויוודעו למפרע, ג"ן:	Deuteronomy 28:29
Paaneach Raza, Ki Tavo 19	והשיבך ה' מצרים באניות, פי' ויהיו שובים גם הטף דאלו להולכי רגל לא הי' ליקח בשבי רק האנשים והנשים היכולים לילך, לאפוקי באניות בא לכלול גם הטף:	Deuteronomy 28:68
Paaneach Raza, Ki Tavo 20	ואין קונה, כי יאמרו המצריים גם חנם לא נקח מהם, שאבותינו השתעבדו בם ולקו כ"כ, ומתוך כך השבאים חובטים מכים ומענים אותם ביסורים קשים ומרעיבים אותם:	Deuteronomy 28:68-69
Paaneach Raza, Ki Tavo 21	למען תשכילו, כלומר השכילו והתבוננו והוו משמשים מאהבה ולא ע"מ לקבל פרס והשכר ממילא בא שאין הקב"ה מקפח שכר כל בריה ובריה:	Deuteronomy 29:8
Paaneach Raza, Nitzavim 1	@דברים פרשת נצבים	NULL
Paaneach Raza, Nitzavim 2	ובעזר השם רכובו עבים, נתחיל סדר אתם נצבים:	NULL
Paaneach Raza, Nitzavim 3	היום כלכם, כלומר לאפוקי אחרי עברכם את הירדן תתפרדו איש לנחלתו וא"א לאסוף אח"כ טף ונשים שלא יהא א' מכם חסר, לכן אמר היום:	Deuteronomy 29:9
Paaneach Raza, Nitzavim 4	גפרית ומלח שכ"מ שיפול גפרית נופל מלח עמו, וכן בסדום וה' המטיר וגו' גפרית ואש וכתיב ותהי נציב מלח שנפל עליה מלח, בכור שור:	Deuteronomy 29:22
Paaneach Raza, Nitzavim 5	וישלכם וגו' ל' רבתי ומשוכה הרבה להלאה לרמוז על השלכה רחוקה גדולה של עשרת השבטים שהשליכם אחר הרי חושך ומעבר לנהר סמבטיון ששוב לא חזרו, ולכך כתיב חסר יו"ד בין ל' וכ' שעל חסרון י' שבטים ידבר, (ד"א שלכן למ"ד רבתי וחסר יו"ד לדרוש הל' לעצמה ומותר המלה לעצמו, דהיינו כי זולת הל' הוא וישכם, לומר כי עם כ"ז שיתשם ה' מעל אדמתם אעפ"כ יהו נשארים בישות וקיום ודבקים בו ית' למעלה למעלה כהמשך אות ל' כלפי מעלה ע"ד ואף גם זאת וגו', וגם להנחיל לאוהביו י"ש ושי"ש תקוה לאחריתך ושבו בנים לגבולם, וכל הקיום ודבקות בגלות החל הזה הוא בסבת וזכות הלימוד המעט שלומדים תורה בגלותם ומחזיקים בה, זהו ג"כ ל' גדולה, כלומר כי לימוד גדול, שבלא"ה לטעם זה נמשכה אות למ"ד בצורתה כלפי מעלה באלפ"א בית"א לרמז נמנו וגמרו שתלמוד גדול שמביא לידי מעשה, והנה הרמז ע"ד שדרשו ז"ל בענין קללת בלעם כולם חזרו לקללה חוץ מבתי כנסיות ובתי מדרשות, וכן נרמז זה גם בתוכחה ראשונה בפסוק ואף גם זאת שלכן נקט לשון זאת המורה על כנוי התורה לומר שבשבילה לא יגעל ולא ימאס, ואוי נא לנו כי חטאנו בדור השפל והבזוי הזה שלא קמה עוד בנו רוח ריח תורה ולימוד, הוא ית' ברחמיו יערה עלינו ממרום רוחו אמן, ועוד רמז שתמשך ההשלכה וגלות ארך הזמן בהמשך רב כמונו היום בגלות המר הזה, זהו למ"ד רבתי, כי ההמשך מיוחס לאות הזה ביותר מלכל זולתו, בפרט שנמשכה למעלה, כלומר לומר שיהי' ערך הארך וההמשך של השלכה זו למעלה מהשיעור ויותר מדאי כי גם עונינו רבו למעלה ראש וגו', וכל עיקר זה בסבה שכתבנו על הביטול והמיעוט בלימוד התורה שנרמזה ג"כ באות זה כנז', וכבר יש לנו עוד רמזים רבים בזה בקונטרס הזכרונות יעויינו משם אם יגמור עלינו הגומר ית' שיצא לאורה בקירוב):	NULL
Paaneach Raza, Nitzavim 6	וישלכם אל ארץ אחרת וגו', וסמיך לי' הנסתרות וגו' לומר שהקץ מכל עין נסתר ונסתם:	Deuteronomy 29:27
Paaneach Raza, Nitzavim 7	הנסתרות לה' אלהינו, פי' בשביל שכתוב אח"כ והבדילו ה' לרעה וגו' וכן הרבה הכל בלשון כינוי ליחיד, דמשמע שהרעה תשוב על ראש החוטא לבדו, וכתיב וראו את מכות הארץ, על אשר עזבו, וכן הרבה דמשמע שכל הארץ והכל לוקין בשביל האיש או משפחה או שבט של שורש פורה ראש ולענה, לכן אמר הנסתרות לה' אלהינו וגו' כלומר לענין עבירות הנסתרות מאתנו ואינם ידועים אלא לה' אלהינו אותן יפרע מהחוטא לבדו ומן העושה רע כרעתו ולא ילקו עליו זולתו, אבל הנגלות לנו ואין אנו מבערים הרע מקרבנו זה לנו ולבנינו ליענש עליו, וע"ז נאמר כל הכתוב בלשון רבים:	Deuteronomy 29:28
Paaneach Raza, Nitzavim 8	לנו ולבנינו, ע' במסורה גדולה בדבר הניקוד שעל לנו ולבנינו ועל ע' שבעד, ומשמע שם דמסופק אם העניש על הנגלות את הרבים קודם שעברו את הירדן אם לא ודלא כרש"י, ג"ן:	Deuteronomy 29:28
Paaneach Raza, Nitzavim 9	(ואני אומר בניקוד הזה שבא לומר שעתיד הקב"ה להנחיל לכל צדיק וצדיק י"ש עולמות, כי לנו ולבנינו עם הע' שבעד עולה ש"י במספר, ושיעור ומכוון הפסוק כך הוא, שאחר שהפריז לספר ולהזהיר מקושי וכובד הגליות ועונשם על עזבם את ברית ה' אלהי אבותם וגו' ויתשם וגו' וישליכם וגו' חוזר ומסיים בטובה על עושי רצונו, וגם שלא יתייאשו מרב טוב הצפון, ואמר הנסתרות, ר"ל עולמות הנסתרות לה' אלהינו אשר עין לא ראתה זולתי אלהים והעולמות הנגלות לנו ולבנינו בעולמו של משיח וכיו"ב אשר השגתינו משגת ומגעת בם אשר בין כולם מספרם כאותיות המנוקדות כאלה, כולם כאחד מוכנים ומזומנים הם לנו ולבנינו עד עולם בשכר לעשות את כל דברי התורה כזאת וזהו עד עולם, דמלת עולם קאי אהנסתרות והנגלות ומבאר שבעולמות ידבר, ואומר שכל כך עולמות של טובה וקורת רוח כמספר לנו ולבנינו וע' מוכנים כולם לנו ולבנינו ולנצח נצחים לעשותינו רצונו ית', ועוד לנו בזה דברים נכונים למבין וישרים למוצאי דעת אשר לא נאריך בהם במקום הזה):	NULL
Paaneach Raza, Nitzavim 10	ושב ה' אלהיך וגו', בפ' בתרא דמגילה דרשו מדלא כתיב ישוב כ"א ושב מלמד שהוא עצמו ישוב עמהם, ותימה א"כ ושב ה' את שבות בני עמון מאי איכא למימר, ה"נ דנימא הכי דישוב עמהם, וי"ל דשאני הכא דדריש ושב יתירא דתרי ושב כתיבי ש"מ לדרשא:	Deuteronomy 30:3
Paaneach Raza, Nitzavim 11	העידותי בכם היום את השמים וגו', פי' כמו שפירש"י לקמן בהאזינו שאמר משה המה יעידו עליכם וידם בכם ראשונה אם לרעה אם לטובה כדכתיב יד העדים תהי' וגו', בכור שור:	Deuteronomy 30:19
Paaneach Raza, Vayeilech 1	@דברים פרשת וילך	NULL
Paaneach Raza, Vayeilech 2	ובעזרת בהלו נרו עלי ראשי לאורו אלך, נתחיל סדר וילך:	NULL
Paaneach Raza, Vayeilech 3	בן מאה ועשרים וגו' לא אוכל וגו' פי' לפי פשוטו כי זקנתי ועוד וה' אמר אלי וגו' כלומר גם בלא"ה אמר ה' אלי וגו' שלא אעבור ועם כ"ז אינכם מפסידים בזה כלום כי ה' אלהיך הוא עובר לפניך וגו' ואין מנהיג ודבר כמוהו:	NULL
Paaneach Raza, Vayeilech 4	כי אתה תבוא את העם הזה וגו', שמעתי דהאי ויקרא משה ליהושע עם ויצו את יהושע בן נון דלקמן בפ' האחרת שייכי וקאי תרווייהו תכף אחר ויאמר ה' אל משה הן קרבו וגו' דלקמן בסמוך שהקב"ה אמר למשה קרא את יהושע וגו' ואצונו, והיכן מצינו שאמר הקב"ה ליהושע כי אתה תבוא כמ"ש רש"י כאן אלא ואצונו פי' כלומר על ידך שאתה תצוהו ככתוב באתחנן וצו את יהושע וחזקהו ואמצהו וגו' שאתה תאמר לו כי אתה תביא וגו' בשמי, והלשון מוכרח כן ומסודר יפה לפ"ז, שאמר הקב"ה למשה קרא את יהושע ואח"כ ויקרא משה ליהושע וגו' ויצו את יהושע וגו', ובשביל שקראו לעיני כל ישראל ובמעמדם חלק כבוד מתחלה לזקנים ואמר כי אתה תבוא את העם דמשמע עם עצת הזקנים כפירש"י אבל באמת הש"י לא אמר לצוותו כי אם אתה תביא וגו' דבר אחד לדור וכו' לכן א"ל פ"ש אח"כ את דברי ה' כענינן וכהווייתן, הר"י מאורליינש:	Deuteronomy 31:7
Paaneach Raza, Vayeilech 5	הן קרבו ימיך דרשו רז"ל הן פי' אחת שכן בלשון יוני קורין לאחת הונא, וא"כ מת משה אחר שחלה חמשה ימים, כי הן הוא אחת, קרבו תרי, הרי תלת, ימיך תרי, הרי חמש, והרי אמרו המת לחמשה ימים ה"ז מיתה חטופה, אלא ה"מ כשלא הגיע לגבורות, אבל אם כבר הגיע לגבורות אפי' מת פתאום ה"ז מיתת נשיקה, בכור שור:	Deuteronomy 31:14
Paaneach Raza, Vayeilech 6	והסתרתי פני מהם דרך חבה כמי שמצוה לרבו של בנו להכותו על שחטא לאביו והוא הולך לו וא"י לראות במכות בנו מפני שרחמיו עליו ומסתיר פניו מהם, ג"ן:	Deuteronomy 31:17
Paaneach Raza, Vayeilech 7	רעות רבות וצרות דרשו רז"ל שנעשו צרות זו לזו כגון זיבורא ועקרבא וכו' שהמועיל לזה מזיק לזה, וכן בעונותינו בדורותינו אלה שהנכרי מיצר ומייסר לישראל ואם יקבול עליו לשוטר או מושל מתיירא פן ישנאהו ויהרגהו, ואם לא יקבול מתיירא שמא ירגיל לעשות לו כך, הרי הרעות צרות זו לזו, ג"ן:	Deuteronomy 31:17
Paaneach Raza, Vayeilech 8	ואנכי הסת"ר אסתי"ר, בגימט' אלף ושלש מאות שלשים וששה, זהו אשרי המחכה ויגיע לימים אלף וגו', כלומר שיכלו כל אלה ויבא בן דוד בתחלת ל"ו, שההסתר פנים יהי' במנין הסת"ר אסתי"ר, ואמר דניאל אשרי המחכה ויגיע לכשיעברו שנים האלה, או אשרי קאי אשנת ל"ה עצמה שבה בא יבא במהרה בימינו, וא' של אסתיר הוא שימוש ואינה מן המנין וא"כ גם מספר הסתר אסתיר מכוון לזה, הרי רמז הקץ כאן וגם בכי תבא כדלעיל, ורבינו בכור שור אמר דנראה לו שהקץ הזה הוא רמוז בתשר"ק צפע"ס וכו', תשר"ק הוא אלף, צפע"ס הרי שלש מאות והוא י' שנים אחר ביאת משיח שהוא לאלף ר"ץ כדלעיל. ואז יהי' משיח כבר נמלך, זהו נמל"ך, יטח"ז הוא ל"ד, הרי אלף ושל"ד מכוון עם פסוק אשרי המחכה וגו', שכשיעברו אלף ושל"ד אז בשנת של"ה והד"ג ב"א, כלומר התענוג בא, וכמו הלאסטון ובאדג, שפי' לשון תענוג, א"נ ר"ל שהלויתן בא אז לעשות סעודה לצדיקים, ג"ן:	Deuteronomy 31:18
Paaneach Raza, Vayeilech 9	את דברי השירה הזאת זה האזינו פי' שם כתוב איך שהספיק צרכיהם במדבר ובא"י ושחטאו ושגלו, ושעתידין הם להגאל ב"ב לימות המשיח:	Deuteronomy 31:28
Paaneach Raza, Ha'Azinu 1	@דברים פרשת האזינו	NULL
Paaneach Raza, Ha'Azinu 2	ובעזר אתה אלהינו זה קוינו, נתחיל סדר האזינו:	NULL
Paaneach Raza, Ha'Azinu 3	האזינו השמים וגו', פסוק זה ופסוק הרנינו גוים וגו' שהוא סוף השירה התחלתן וסופן הם אותיות השם הנכבד, לומר שהוא ית' חתמה לשירה זאת בשמו הגדול, (ואני אומר שבשביל שסיפר ורמז בה פשעיהם וגלותם ובפרט בהתחלתה שהתרה בם והעיד בנו על כך לכן בהתחלה רמז חצי השם, כי עי"ז אין השם שלם וכו', ולא עוד אלא שאף כח של שם י"ה כביכול מתישין כנקבה כאלו הי' מבלתי יכולת, ולכן בא השם הזה רמוז הפוך, שהה"י היא קדמה בראש הפסוק והיו"ד אח"כ בסופו כאלו הי' ה"י לשון כנוי לנקבה, שאומרין עליה היא, ושוב רמוז ומסופר בפרשת התשועה ועליית האורה הגדולה, ובפרט בפסוק האחרון כאמור הרנינו וגו', לכן רמוז שם חציה שנית של השם, כי אז יושלם בזה, ורמזו ג"כ מהופך ה' בהתחלת הפסוק ו' בסופו על שיחזור כנוי נקבה לכנוי זכר, הו כמו הוא, כי אז יגדל כח אדני כאשר דבר לאמר, ועוד לנו בזה דברים נכונים ולא נאריך):	Deuteronomy 32:1
Paaneach Raza, Ha'Azinu 4	האזינו השמים פי' הנשמה שהיא צלם ממעל, ותשמע הארץ, זה הגוף הנברא מן הארץ, והוא ע"ד שדרשו רז"ל בפ' יקרא אל השמים מעל ואל הארץ לדין עמו במשל החיגר והסומא:	Deuteronomy 32:1
Paaneach Raza, Ha'Azinu 5	האזינו השמים ואדברה בגימט' תרי"ג, שהציע לפניהם תרי"ג מצות וסדרן לפני העדים:	Deuteronomy 32:1
Paaneach Raza, Ha'Azinu 6	הקשה מוהר"ר יצחק בר ברוך מה נשתנית שירה זו שלא נזכר בה שם משוררה, כמו אז ישיר משה, אז ישיר ישראל, ותשר דבורה וכן כולם, ואמר שגם כאן הוא רמוז, כי ראשי הפסוקים עד פסוק זכור ימות עולם שהוא פרשה אחרת, בסימן הזי"ו ל"ך הם בגימט' מש"ה עיין עליהם (ולא נזכר בפירוש משום שזה הי' סמוך להעדרו ונעלם הזכרון כאלו כבר לא הי' עוד נמצא בעוה"ז, ועוד מפני ששירה זו היא התראה ועדות על כל הצרה העתידה ועל התשועה לכן הסתיר שמו מענותנותו כאלו לא הי' הוא היודע ועד המדבר בדבר הזה:	NULL
Paaneach Raza, Ha'Azinu 7	כי שם ה' אקרא הבו וגו' פי' כשאספר שבחו והנהגתו מה שעתיד לנהוג בעולמו בין לטובה בין לרעה תמיד הבו גודל לאלהינו ואל תהרהרו אחריו:	Deuteronomy 32:3
Paaneach Raza, Ha'Azinu 8	יצא גבולות עמים וגו', פי' שהעמיד גבולות ז' עממין לבני כנען לשיוחלטו לישראל בני שם לחלוטין מטעם מה שקנה עבד קנה רבו, כי כתיב ויהי כנען עבד למו, ועשה זה קודם שעמדו שבטי יעקב כדי שלא יוכלו הכנענים אח"כ לערער על כך, לאפוקי אם הי' הוא ית' מעמיד הגבולות לבני אומה אחרת היו יכולים אח"כ לערער כשהיו ישראל נוטלים אותם והנה בני כנען היו ג"כ י"ב כדכתיב בפ' נח וכנען ילד את צדון בכורו וגו' קחשיב ואזיל שם י"א, ואח"כ אמר ואחר נפוצו משפחות הכנעני פי' שא' מהם נחלק לשתי משפחות שהוציא ממנו גם הפריזי שלא נזכר שמו בין הי"א, וזהו יצב גבולות עמים למספר ב"י שגם זה הי' לשם כונה זו, בכור שור:	Deuteronomy 32:8
Paaneach Raza, Ha'Azinu 9	כאישון עינו, כאלו אמר כאישון שומר את עינו כי אישון הוא העור הנופלת בעת השינה על העין ושומרו וכן בהקיץ חוצץ כנגד כל דבר הבא ליגע בעין, וע"ש לשון שינה ועל שמחשיך ומאפיל נגד העין כאישון לילה נקרא אישון, ג"ן:	Deuteronomy 32:10-11
Paaneach Raza, Ha'Azinu 10	לא אלוה שאין בהם כח וחוזק בעצמם, ג"ן:	Deuteronomy 32:17
Paaneach Raza, Ha'Azinu 11	לא שערום, לא פקדום כלומר לא חשו להם, פוקד עון אבות תרגומו מסער חובי אבהן, ג"ן:	Deuteronomy 32:17-18
Paaneach Raza, Ha'Azinu 12	אספה עלימו רעות לשון כליון כמו ספו תמו והוא כפול לשון במלות שונות עם חצי אכלה בם, ג"ן:	Deuteronomy 32:23
Paaneach Raza, Ha'Azinu 13	מזי רעב שרופי רעב כמו למזא לאתונא וגו' שהוא ניחר ונקמט מפני זלעפות רעב (ואני כבר זה ימים כבירים פירשתי כן, וכמו מבכות את התמוז, אבל לא מטעמי רק מכח שמצד הרעב לא יוכל החום הטבעי שבאצטומכא לכלות חציו ולפעול כחו בבישול המאכל כמנהגו הוא גובר לקדוח ולשרוף בחום רב באדם, והעד, עורנו כתנור נכמרו וגו' שהעור מתאדם מרוב החום היתר, ותמהתי הרבה על רבינו הגדול רש"י ז"ל שבעצמו וכבודו פי' בפסוק זלעפות רעב לשון שריפה ודלא כדעת אונקלוס שם שפי' בו מפח כפנא למה א"כ לא פי' הוא גם כאן הכי ומפרש מזי לשון שערות ואונקלוס צריכינן למימר שהוציא שם גם עורנו כתנור נכמרו מלשון שריפה, דאם יפרשנו כן למה א"כ הוציא זלעפות לפי' אחר):	Deuteronomy 32:24
Paaneach Raza, Ha'Azinu 14	אני אמית ואחיה אמית בחילוף א"ת ב"ש הוא ג"כ אמית וכן צדקה ישוב בחילוף א"ת ב"ש לתיבת צדקה לומר כי הצדקה תציל משתי מיתות בעוה"ז ובעוה"ב, (ד"א אמית ירמוז בו שיש מיתה אחר מיתה כנזכר דהיינו מיתת הגוף ומיתת הנפש ב"מ, וירמוז לסוד הגלגול שיש מיתה אחר מיתה, הרמוז בהן כל אלה פעל אל פעמים ושלש וגו' ובצדקה ירמוז שבנתינתו ימצא גם הוא צדקה וצדקה תהי' לו ככתוב רודף צדקה וחסד ימצא צדקה וגו', וכפי דרוש רבותינו ז"ל בו, ועוד ירמוז בזה שיתן ויחזור ויתן דהיינו נמי שיש צדקה אחר צדקה, ועוד ירמוז שהנותנה נתינתו כפולה, על דרך מלוה ה' חונן דל):	Deuteronomy 32:39
Paaneach Raza, Ha'Azinu 15	ואין אלהים עמדי בזה יש תשובה לנוצרים וכן במאמר חי אנכי לעולם ותיפח רוחם, ג"ן:	Deuteronomy 32:39
Paaneach Raza, Ha'Azinu 16	וסימן פרשיות הללו הזי"ו ל"ך, והוא שם א' משמותיו של הקב"ה ואמרו במדרש שמשה אמר לשירה זו ע"פ ע"ח זקנים כמנין הזי"ו ל"ך, מצאתי:	NULL
Paaneach Raza, Ha'Azinu 17	(ולדעתי יסכים גם לזה מה שאמרו על מטטרון שמו כשם רבו, דזולת מה שמספר מטטרו"ן עולה בגימט' שדי עוד דברים בגו, הלא ידענו כי חנוך זה מטטרון וחנ"ך הוא בגימט' הזי"ו ל"ך הרי גם בשם זה הוי שמו כשם רבו):	NULL
Paaneach Raza, Ha'Azinu 18	וכפר אדמתו עמו, פי' וכפר מעון עמו ואז ינוח דם עמו זהו אדמתו אותיות את דמו כלומר שיכפר על עונם כמשפטו ואז ינוח דמם אשר שופך כי כענין אחר אין כפרה לארץ כדכתיב ולארץ לא יכופר לדם אשר שופך בה כי אם וגו', ג"ן:	Deuteronomy 32:43-44
Paaneach Raza, Ha'Azinu 19	הוא והושע בן נון, תימה למה קראו כאן בשם הושע, וי"ל דמה שקראו משה יהושע כדכתיב ויקרא משה להושע בן נון יהושע הוא מטעם שכתבנו במקומו שכן דרך השרים ומלכים לשנות שמות משרתיהם הנאמנים כרצונם כשבאים לשירותם כביוסף דניאל חנניא מישאל ועזריה הנה עתה במקום הזה יצא יהושע משירותו של משה ונעשה הוא המלך חזר לשמו הראשון, בכור שור:	Deuteronomy 32:44-45
Paaneach Raza, V'Zot HaBerachah 1	@דברים פרשת וזאת הברכה	NULL
Paaneach Raza, V'Zot HaBerachah 2	ובעזר שם ברית עולם בכל ערוכה, נתחיל סדר וזאת הברכה:	NULL
Paaneach Raza, V'Zot HaBerachah 3	וזאת הברכה וגו', הואיל ועד כה קנטרן בתוכחות חזר וברכן וקשה למה לא בירך את שמעון וי"ל דדעתו הי' מתחלה שלא לברך את שמעון ולוי גם שניהם מפני שלא ברכן יעקב אלא שלוי זכה לברכה ממעשה העגל שנאמר מלאו ידכם היום לה' וגו' לתת עליכם היום ברכה, כלומר היום זכיתם לברכה:	Deuteronomy 33:1
Paaneach Raza, V'Zot HaBerachah 4	איש האלהים, דוקא כאן נקרא כן להורות שהברכות האלה לא מפי עצמו היו, כ"א כאשר צוה אותו אלהים, א"נ לומר כי כדאין ברכותיו להתקיים כי איש אלהים הוא, תיט"ב:	Deuteronomy 33:1
Paaneach Raza, V'Zot HaBerachah 6	(ד"א לומר כי עם היות מדתו מדה"ד כמדת שם האלהים וכנאמר ואתה תהי' לו לאלהים ומטה האלהים בידו, והדבר ידוע עכ"ז ברכן עתה קרוב למיתתו, כי גם מדה"ד נותנת זה שיברכו הצדיקים בעת מותם בהיותם יותר רוחניים וקרובים אל הש"י בטרם ימותו):	Deuteronomy 33:1
Paaneach Raza, V'Zot HaBerachah 6	א"ש ד"ת גימט' בא"ת ב"ש, מכאן ראי' לחילוף א"ת ב"ש מה"ת:	Deuteronomy 33:2-3
Paaneach Raza, V'Zot HaBerachah 7	אף חובב עמים דכתיב והייתם לי סגולה:	Deuteronomy 33:3
Paaneach Raza, V'Zot HaBerachah 8	כל קדושיו בידך כולם יעידון יגידון רצוננו להיות תחת ידך, ד"א אף חובב עמים וגו', הם שאר אומות שכל קדושיהם נותנין עצמן בידך ומתגיירין, אבל והם כלומר ישראל תכו לרגליך שעמדו בתחתיות ההר במתן סיני לקבל תורה ויתרון רב להם, ג"ן:	NULL
Paaneach Raza, V'Zot HaBerachah 9	ורבינו בכור שור פי' אף בשעה שהקב"ה חובב שאר עמים ומוסר כל קדושיו, אלו ישראל בידם, אעפ"כ והם תכו וגו' שמתכתתין בשבילך, זה לרגלך כמו ויברך אותך לרגלי ומקדשים שם שמים:	NULL
Paaneach Raza, V'Zot HaBerachah 10	כל קדושיו בידך מוסרין עצמן בידך על קדוש שמך וסובלין יסורין בשבילך, זהו תכו לרגליך, ג"ן:	NULL
Paaneach Raza, V'Zot HaBerachah 11	תורה צוה לנו משה ושמא תאמר מה לנו ולציוויו זהו ויהי בישורון מלך שהרי הוא מלך עלינו ויאות לו לצוות עלינו ואימת הי' זה בהתאסף וגו', כלומר משעה שא"ל הקב"ה לך ואספת וגו' וכתיב ויאספו אליו וגו' באותה שעה נעשו כולם כפופים תחת ידו והמליכוהו עליהם, והא דכתיב לפני מלוך מלך נראה שעל משה נאמר, דאי תימא על שאול וכי האריכו ח' מלכי אדום ההם כ"כ עד שאול, תיט"ב:	Deuteronomy 33:4
Paaneach Raza, V'Zot HaBerachah 13	ד"א בהתאסף וגו', בשעה שאמר הקב"ה הקהל לי את העם ואשמיעם את דברי ואמרו נעשה ונשמע אז חלתה עליהם המלוכה:	Deuteronomy 33:4
Paaneach Raza, V'Zot HaBerachah 13	יחי ראובן ואל ימות, פי' לא ימות בעון חלול יצועי אביו:	Deuteronomy 33:6
Paaneach Raza, V'Zot HaBerachah 14	ויהי מתיו מספר בארבעים אלף חלוצי צבא העוברים לפני ה' למלחמה ובדגלים וחנוכת המזבח וייחוס הבכורה, ואע"פ שכתוב בו ובחללו יצועי אביו ניתנה בכורתו ליוסף, לא ניתנה לו להתייחס לבכורה:	Deuteronomy 33:6
Paaneach Raza, V'Zot HaBerachah 15	ד"א יחי ראובן, ויעבור חלוץ את הירדן, ואל ימות במלחמה, ויהי מתיו מספר שלא נפקד ממנו איש, ד"א ואל ימות ויהי מתיו וגו', אל משמש לשניהם כלומר ואל יהא מספר למתיו, כמו אל בקצפך תוכיחני ובחמתך תיסרני דקאי נמי אל אתרווייהו, ומה שהקדים ה' מסיני בא וגו' הכל קודם התחלת ברכות השבטים ולא אמר תכף אחר וזאת הברכה יחי ראובן וגו' הוא מפני שהי' מתן סיני סבה לחול עליהם ברכה במה ששום אומה לא רצו לקבל התורה והם קבלוה ואמרו נעשה ונשמע וכן גבי יצחק אמר ועשה לי מטעמים וגו' בעבור תברכך נפשי שיעסוק תחלה במצוה ויהא מקום לברכה לחול, וכן להיפך בבלעם וישת אל המדבר פניו להקדים זכרון מעשה עגל כדי שתחול הקללה, הר"ר שמואל:	Deuteronomy 33:6
Paaneach Raza, V'Zot HaBerachah 16	וזאת ליהודה כלומר ברכת ראובן עצמה בירך ג"כ ליהודה שלא יהא נפקד ממנו איש כי הוא המוציא והמביא:	Deuteronomy 33:7
Paaneach Raza, V'Zot HaBerachah 17	וללוי אמר עשר אמירות בענין נגד עשרה מאמרות לומר כי בשביל השבטים העולם נברא:	Deuteronomy 33:8
Paaneach Raza, V'Zot HaBerachah 18	תמיך ואוריך לאיש חסידך, דברים שכל ישראל צריכים להם מסרת לזה בשביל שכולם חסידים ולא נכשלו בעגל:	Deuteronomy 33:8
Paaneach Raza, V'Zot HaBerachah 19	אשר נסיתו במסה ולא פירשו משה ואהרן את דבריהם כדלעיל בממי מריבה:	Deuteronomy 33:8
Paaneach Raza, V'Zot HaBerachah 20	האומר לאביו ולאמו וגו' כלומר שיכול לומר עליהם שלא ראה אותם חוטאים בעגל, וכן ואת אחיו לא הכיר ואת בניו לא ידע לחוטאים בחטא ההוא כי כולם כא' שמרו אמרתיך וגו', רבינו בכור שור:	Deuteronomy 33:9
Paaneach Raza, V'Zot HaBerachah 21	וי"מ דלאו לענין מעשה העגל קאי אלא האומר לאביו וגו' שמתגבר ואינו מטמא להם כדכתיב על כל נפשות מת לא יבא וכן ואת בניו לא ידע לשבחו של כהן גדול שעובד ועוסק במצות מלכו אף בשעת צער אשר אין אדם נתפס עליו אעפ"כ אינו חש, וזהו כי שמרו אמרתיך וברית כהונה ינצורו:	NULL
Paaneach Raza, V'Zot HaBerachah 22	יורו משפטיך וגו' כדכתיב שפתי כהן ישמרו דעת וגו', ג"ן:	Deuteronomy 33:10
Paaneach Raza, V'Zot HaBerachah 23	חופף עליו כל היום בשבילו במה שבית עולמים נבנה בחלקו הוא משרה שכינתו בעולם וע"ד עיני ולבי שם כל הימים שאפי' בחורבנה השכינה שם משא"כ בנוב וגבעון, הר"ר יוסף קרא:	Deuteronomy 33:12
Paaneach Raza, V'Zot HaBerachah 24	מבורכת ה' ארצו בשביל שלא שמע לקול אשת פוטיפר הפך אדה"ר ששמע לקול אשתו ונתקלל האדמה בעבורו (והטעם בשניהם כי האשה קרקע עולם היא:	Deuteronomy 33:13
Paaneach Raza, V'Zot HaBerachah 25	גרש ירחים, נראה לרבינו בכור שור מלה הפוכה כמו שגר בהמה, שתשלח ארצו בכל ירח וירח פירות הראויות אז, ג"ן:	Deuteronomy 33:14-15
Paaneach Raza, V'Zot HaBerachah 26	ורצון שכני סנה, פי' שתהא ארצו מבורכת במים שהם רצון וחפץ, השוכנים בארץ מגדלת סנאים קוצים וברקנים, מכח שהארץ ההוא יבשה וקשה:	Deuteronomy 33:16
Paaneach Raza, V'Zot HaBerachah 27	בכור שורו הדר לו פי' הדר לו היתרון של בכורה אשר לו יותר מאחיו כי סבה היתה מאת ה' להסירה מראובן ולתתה לו, הר"ר יוסף קרא:	Deuteronomy 33:17
Paaneach Raza, V'Zot HaBerachah 28	ויששכר באהליך שארצו היתה יפה וטובה לזרעים והי' יושב אהלים לשמור שדותיו וברכו להצליח בהן, בכור שור:	Deuteronomy 33:18-19
Paaneach Raza, V'Zot HaBerachah 29	שפע ימים ינקו כיון שבא בשפע והרבה אמר לשון יניקה כמו למען תנקו ושבעתם שהים מיניק יושביו כיניקת החלב, תיט"ב:	Deuteronomy 33:19
Paaneach Raza, V'Zot HaBerachah 30	וספוני טמוני חול, פי' שהים משליך לשפתו כל ממון רב של ספינות טובעות בים וחולו, ושם באים ונוטלים ומתעשרים:	Deuteronomy 33:19-20
Paaneach Raza, V'Zot HaBerachah 31	ברוך מרחיב גד וגו', פי' ברוך הוא כל המרחיב לגד ואינו פוגע בו, כי כל מי שנפגע ממנו לרעה אינו נמלט:	Deuteronomy 33:20
Paaneach Raza, V'Zot HaBerachah 32	וטרף זרוע אף קדקד, שדרך בני אדם כשבאין להכותם על קדקד מרימין זרוע להגין כענין עור בעד עור וגו', וכ"ז איננו שוה למכת גד כי שניהם גם יחד יטרוף:	Deuteronomy 33:20-21
Paaneach Raza, V'Zot HaBerachah 33	כי שם חלקת מחוקק ספון, כתרגומו אע"פ דכתיב ויעל משה אל הר נבו וימת שם ונבו הוא בחלק ראובן כדכתיב ובני ראובן בנו את נבו וגו' ודאי מת שם אבל הוטל בכנפי השכינה ונקבר בגי בחלק גד, ד"א וירא ראשית לו כי שם וגו', פי' שאין מקום לערעור עמון ומואב שיערערו על חלקו של גד, כי אם הי' ראוי להחזירה להם לא הי' הקב"ה קובר את משה מתחלה שמה, אלא שראה מראשית שראוי' להיות נשאר לגד כי שם וגו', ג"ן:	NULL
Paaneach Raza, V'Zot HaBerachah 34	יזנק מן הבשן, שישקה עצמו מן הירדן היורד מן הבשן, שהירדן יוצא ממערת פמייס ודרך ארצו של דן, שלכך נקרא ירד"ן יורד לדן:	Deuteronomy 33:22-23
Paaneach Raza, V'Zot HaBerachah 35	ומלא ברכת ה' ע"ש שינוי חידושי פירות שמברכים עליהם:	Deuteronomy 33:23
Paaneach Raza, V'Zot HaBerachah 36	יהי רצוי אחיו התפלל משה על אשר שיותר לו נדוייו שהי' בנדוי מאחיו על כי הגיד מעשה ראובן:	Deuteronomy 33:24
Paaneach Raza, V'Zot HaBerachah 37	וכימיך דבאך, מלשון דאבה ככל תיבות הפוכות, שלמה שמלה וכמוהם, ופי' מרוב שמן אין לו דאגה ודאבה אף בזקנותו שהן ימי דאבה וכדאמר ר' חנינא שמן שסכתני אמי בבחרותי עמד לי בזקנותי, ר' יוסף קרא:	Deuteronomy 33:25-26
Paaneach Raza, V'Zot HaBerachah 38	בטח בדד נקוט כללא בידך, כל בדד שאצל ישיבה הוי לרעה, כמו איכה ישבה בדד, בדד ישב וכיוצא, לכן נאמר כאן וישכן, כי אצל לשון שכונה לטובה הוא שאחר שגירשו אומות מארצם שכנו בה לבדם בטח וכדכתיב הן עם לבדד ישכן:	Deuteronomy 33:28
Paaneach Raza, V'Zot HaBerachah 39	ואשר חרב גאותך שמאחר שה' מגן עזרך ואינך צריך מגן וחרב, לכן מה שאתה חוגר חרב אינו אלא מדרך גאוה, ר' שלמה הנקדן:	NULL
Paaneach Raza, V'Zot HaBerachah 40	וימת משה וגו', בהקומץ רבה אלו ח' פסוקים יחיד קורא אותם, פירש"י שם שאין לחלקם לשנים, וי"מ יחיד וגדול, כמו יחידים מתענין, והוא יקראם לחשיבות סיום התורה ונוטל שכר כנגד כולם ומברכים אותו בצבור ונקרא חתן תורה, מוהר"ר חיים:	Deuteronomy 34:5
Paaneach Raza, V'Zot HaBerachah 41	(ויראהו ה' שאלמלא הראהו הקב"ה בעצמו וכבודו אין כל ברי' יכולה לראות מה שראה הוא, וזהו הראיתיך בעיניך, וכן בואתחנן וראה בעיניך ר"ל בעינים המיוחדים לך שעשיתי אני לך עינים חדשים מיוחדים רוחניים במה שהראתיך בעצמי וכבודי עד שתוכל להשיג ולראות כל אלה):	NULL
Paaneach Raza, V'Zot HaBerachah 42	ויקבר אותו בגי וגו', פי' ואע"פ שנתנה תורה ג' סימנים הללו אפ"ה לא ידע איש וגו', למדנו שנגנז ארונו במקום קדוש שאין העין שולטת בו, לא כהתה עינו, פי' מראיתו ודמותו כמו עין הבדולח, ויבכו בני ישראל, ואלו כשמת אהרן כתיב כל בית ישראל דפירושו אפי' הנשים, מפני שאז מפני בכיית משה בכו כולם לכבודו ויראתו, אבל כאן לא הי' גדול כמשה שבכה, לא בכו אלא האנשים:	Deuteronomy 34:6
Paaneach Raza, V'Zot HaBerachah 43	ולא קם נביא עוד בישראל לפי הפשט פי' אפי' בישראל ואצ"ל באומות, שהרי בקש שלא תשרה שכינה באומות כדכתיב ונפלינו אני ועמך, בכור שור:	NULL
Paaneach Raza, V'Zot HaBerachah 44	פנים אל פנים, כמו שפירשנו אצל ולא בחידות:	Deuteronomy 34:10-11
Paaneach Raza, V'Zot HaBerachah 45	אשר עשה משה לעיני כל ישראל, לא כשאר כל הנביאים, שכל מופתים ונפלאות שעשו הי' ליהודים (ליחידים) כאליה ואלישע וכן כולם, אבל משה כל מה שעשה הי' לצורך כל ישראל במעמדם לעיניהם להם ולדורותיהם הבאים אחריהם, ג"ן:	Deuteronomy 34:12
