Paaneach Raza, Bamidbar 1	@במדבר פרשת במדבר	NULL
Paaneach Raza, Bamidbar 2	ובעזר אשר זבחו הוא רוח נשבר, נתחיל חומש וסדר במדבר:	NULL
Paaneach Raza, Bamidbar 3	וידבר ה' וגו' כאן מתחיל חומש הפקודים ומתחיל בוי"ו כדי להשלים מנין ר"ת שבתחלת ה' חומשי התורה למספר כ"א דהיינו ב' בראשית, ג' ווי"ן של שמות ויקרא ובמדבר, א' של אלה הדברים הרי כ"א שנחתם שמו ית' של אהי"ה העולה כ"א עליהם בראשיהם (והוא הטעם שנקראת התורה תורת אמת, כי ידענו שחותמו אמת והוא הוא אהי"ה שנקרא חותמו ועולה כמספר אמת כשכופלין אותו על עצמו, אהי"ה פעמים אהי"ה כרמז הפסוק אהיה אשר אהיה, וא"כ הרי התורה חתומה בראשית בחותמו אמת ניתנה, ובא החותם הזה בראשי החומשים דוקא לרמז ה' קנני ראשית דרכו וגו' ונאמר אני נסכתי מראש) וזה שאמר הכתוב א"ך טוב לישראל, לומר שהתורה החתומה בשם א"ך כנזכר היא ניתנה לישראל לטובתם וכדכתיב ה' חפץ למען צדקו וגו', לוי:	NULL
Paaneach Raza, Bamidbar 4	וסופי תיבות של סופי החומשים הם אותיות מ"ם יו"ל, שהם אותיות מי"ם ל"ו, לומר שהתורה הנמשלת למים היא לאדם לקנין עצמיי לו כשילמדנה ע"ד ובתורתו יהגה וגו' וכדאיתא ע"ז בגמרא (ובא הרמז בס"ת בסוף החומשים לומר כי סוף הכבוד לבא, ולבסוף דוקא הוא שלו, דאלו תחלה נקראת כי אם בתורת ה' חפצו, ועוד רמז באלו סופי החומשים אותיות למ' יו"ם לומר כי כל החומשים כולם עד סופן ניתנו גם יחד למשה מאתו ית' למ"ם יום, ולא כתב משה אף אות אחת שלא מפיו ית', ורמז עוד בזה שגם שמונה פסוקים אחרונים כתבם משה, ובמ"ר משה כתבן בדמע):	NULL
Paaneach Raza, Bamidbar 5	שאו את ראש וגו' הוא פעם ראשונה שנמנו ומה שנאמר ביציאת מצרים כשש מאות אלף רגלי, לא נאמר אלא בדרך אומדנא שזהו מנין כ"ף הדמיון ולא אמר שש מאות וגו', ועוד שהרי לא פרט שם שום פרטיים רק כשש מאות אלף במכוון, ואילו נמנו שם וכי אתרמי של הי' בם שום פרטי (אבל י"ל היא הנותנת דודאי נמנו שם והי' ג"כ שם פרטיים מאות ויחידים ועליהם באה כ"ף הדמיון להורות על הנותרים שלאו דוקא שש מאות אלף במכוון הי', וכנהוג בלשון בני אדם לדבר כך), ומ"ש באלה פקודי בקע לגלגולת לשש מאות אלף וגו', הוא הוא המנין שבכאן אלא שזכרו שם לחשבון הכסף שהוצרך למשכן, וזהו עצמו לשון בקע לגלגולת כלומר בקע לכל הנמנין בכאן לגלגלותם כדכתיב הכא לגלגלותם, ולהראות חיבתן וקדושתן של ישראל דאתרמי הכי שהחשבון בקע לכל גלגולת נתכוון לצורך המשכן במכוון, אבל אין לומר שנמנו ב"פ דאיך לא פחתו ולא הותירו במנין השני, ובערבות מואב מנו הנולדים במדבר סמוך לכניסתן לארץ כי אלו מתו כולם במדבר כדכתיב ובאלה לא הי' איש מפקודי משה וגו', ועיקר הפשט נראה לרבינו בכור שור כי ע"י בקע לגלגולת ידענו מנין ישראל בכללם במנין הראשון, שלכן לא כתיב התם רק כשש מאות וגו' אבל כאן מנו כל שבט ושבט לעצמו בפרטות וכל דגל ודגל כדכתיב למשפחותם לבית אבותם שהם שני דברים אלו:	NULL
Paaneach Raza, Bamidbar 6	באחד לחודש, פירש"י מתוך חיבתן וכשנפלו בעגל מנאן וכו', תימה למה א"כ מנה בני לוי שהרי הם לא נפלו בעגל, וי"ל משום משא שלהם:	Numbers 1:1
Paaneach Raza, Bamidbar 7	ואלה שמות האנשים וגו', כאן מנאן בסדר תולדתן, ובסדר הדגלים מנה גד אחר שמעון, לפי שעתיד להיות גד עם ראובן בנחלה מעבר לירדן, לכן התחיל בראובן הבכור, ואחריו שמעון כסדרן, ואח"כ גד במקום לוי, שלא נטלו נחלה, וא"ת למה לא צירף א"כ גם מנשה עמם בדגל שגם הוא הי' עם ראובן בנחלה ההיא, וי"ל כדי שיהיו בני רחל בדגל אחד, יאיר:	Numbers 1:5
Paaneach Raza, Bamidbar 8	(ועי"ל לפי שלא הי' כ"א חצי שבט מנשה עמו בנחלה ואין לחלוק שבט א' לב' דגלים):	Numbers 1:5
Paaneach Raza, Bamidbar 9	ואלה שמות האנשים וגו' פי' שניתנו השמות להדרש דזהו לראובן אליצור בן שדיאור, שנקרא נשיא ראובן כן ע"ש ענין ראובן שמחל לו הקב"ה על מעשה בלהה, וזה אל"י צו"ר, מה הצור הזה סובל כל הבנין כך אלי סבל עוני ומחל לי בעשותי תשובה בן שדיאור שממי למד ראובן לעשות תשובה, מיהודה שצוה להשליך תמר כלתו לאור, כדכתיב הוציאוה ותשרף, זהו שד"י או"ר, שדי לשון השלכה, ירה בים מתרגמינן שדי בימא, לשמעון שלמיאל בן צורי שדי שאע"פ שחטא שמעון במעשה זמרי בשטים נתן לו א"ל שלו"ם, מנין שהרי בדגלים סמכו לראובן אשר מחל לו, זהו בן צור"י שד"י שהשליכו וסמכו אצל צורי, הוא ראובן כנזכר בשם אליצור, ליהודה נחשון וגו', ע"ש שירד לנחשול של ים תחלה, נ' ול' מתחלפין כמו נינוס נילוס, נשכות לשכות, והוא נחשון כמו נחשול, בן עמינדב שלכך נעשה מושל ונדיב על עם ה' אלה, שזכה למלכות וזהו שנאמר בצאת ישראל ממצרים וגו' היתה יהודה לקדשו וגו' שבזכות שהיתה יהודה לקדשו, שקידש שמו של הקב"ה בים בצאת ישראל זכה שיהיו ישראל תחת ממשלותיו:	Numbers 1:5
Paaneach Raza, Bamidbar 10	ליששכר נתנאל בן צוער, שבני יששכר יודעי בינה לעתים ויט שכמו לסבול עול תורה שנת"ן א"ל, בן צוער, שבזה קבלו עליהם כל טורח וצער, להשיב לכל ישראל ששואלין להם, וכן הוא אומר, וכל אחיהם על פיהם, לזבולון אליאב, ע"ש הברכה שבירכו אביו לומר זבולון לחוף ימים ישכון זהו אל"י ע"ש שעשו מאלונים ועצי שטים ספינות, א"ב לשון ספינה כדכתיב חלפו עם אניות אבה, בן חילו"ן, ע"ש הברכה שבירכו משה ושפוני טמוני חול:	Numbers 1:8-9
Paaneach Raza, Bamidbar 11	לבני יוסף לאפרים וגו', הקדים אפרים למנשה לקיים מה שנאמר וישם את אפרים לפני מנשה, אבל בחלוקת הארץ הקדי' למנשה בעבור שחצי שבטו קבלו נחלתם כבר בטרם נכנסו לארץ, אל"י שמ"ע, ע"ש ארונו של יוסף שהיו נושאין אותו אצל ארון העדות, שזהו בן עמיהוד, כלומר עמ"י הוד"ו, שהודו של השי"ת שהוא ארונו הולכת עמו, וזהו אל"י שמ"ע, ששמע אלי וצוה עמי הודו:	Numbers 1:10
Paaneach Raza, Bamidbar 12	למנשה גמליאל בן פדהצו"ר, ע"ש שקידש יוסף שמו בסתר באשת פוטיפר זהו גמל"ו א"ל ופדא"ו צור"ו מדינה של גיהנם שבשעה שתבעתו אשת אדונו פתחה שאול פיה נגדו. והוא שם יראת צורו נגד עיניו ורחק ממנה:	Numbers 1:10-11
Paaneach Raza, Bamidbar 13	לבנימין אבידן בן גדעוני, ע"ש שיעקב הי' דן ומתבונן במה שהגידה רחל לקרותו בן אוני, כלומר מתאונן ומתגונח והולך, ונתעצם אביו וקרא לו בן ימין, שיהא בריא אולם וחזק בכח ימין, זהו אב"י ד"ן בן ג"ד אונ"י:	Numbers 1:11-12
Paaneach Raza, Bamidbar 14	לדן אחיעזר ע"ש שנעשה אהליאב למטה דן א"ח ועז"ר במלאכת המשכן לבצלאל למטה יהודה שנקרא ג"כ עזר כדכתיב ועזר מצריו תהי', ושנקרא בן עמי, ע"ש שדן עמו ומלך עליהם כדלעיל ושנקרא שדי כדלעיל על שם הוציאוה וגו':	Numbers 1:12-13
Paaneach Raza, Bamidbar 15	לאשר פגעיאל בן עכרן, שאשר הי"ל בנות יפות, וכל שהי' עכור ומחויב ראשו למלכות היו בנותיו מפגיעות ומבקשות רחמים מהמלך ומחל לו:	NULL
Paaneach Raza, Bamidbar 16	לגד אליסף שהוסיף להם א"ל ממון על ממונם, מכיון שידע"ו א"ל וקיימו מצותיו לבא לעזרת אחיהם:	Numbers 1:14-15
Paaneach Raza, Bamidbar 17	לנפתלי אחירע, ע"ש נפתלי שבע רצון שארצו הוציאה פירות כרצון בעליה אח"י לשון ארץ מבורכת כענין ותרענה באחו, וכתיב בין אחים יפריא, ר"ע לשון רצון כתרגום יהא רעוא, בן עינן, שהיו עננים רבים ועיינות רבות משקים את ארצו:	Numbers 1:15-16
Paaneach Raza, Bamidbar 18	אלה קרואי העדה, קריאי כתיב קרואי קרי, לומר שכל הקרואים לעדה ראוים לי' דברות ולהיות שרי עשרות (ול"נ בשביל שאלו מיוחדים וקרואים לכל דבר חשיבות וקדושה של עדה שהוא עשרה, לכן נקטעה וי"ו של קרואי ונעשית יו"ד שנקראים לכל קדושת קהל ועדה, וזהו עצמו פי' קריאי העדה, ובפ' קרח קראי חסר יו"ד ראשונה לגמרי, מפני דהתם כתיב קראי מועד ולא קריאי עדה של עשרה, עד שתהי' יו"ד ראוי' לבא בתוך התיבה, שהרי דרשו בו בפ' חלק קראי מועד שיודעין לעבר שנים ולקבוע חדשים כי כולם היו ראשי סנהדראות וידענו מקראי במסכת ר"ה שעיבור שנים וקיבוע חדשים ראש ב"ד קורא מקודש מקודש והעם עונים אחריו, זהו א"כ קראי חסר יו"ד, להורות שאין הדבר תלוי בעדה של עשרה שהם רבים רק בראש ב"ד שקורא לפניהם, ועוד כי בלא יו"ד הוי כמו קוראי שהוא לשון פועלי שקוראין מקודש החודש או השנה, לא כמו קריאי שהוא לשון נפעלים כמו נקראים דמשמע שנקראים לכ"ד שבקדושה, ובפ' פנחס אצל דתן ואבירם הוא ממש היפך מבכאן שהכתב הוא קרואי וקרינן קריאי, באשר שם ג"כ כתיב העדה שנקראין לכ"ד עדה, אבל הענין הפוך מבכאן דאינו ר"ל שנקראים לכ"ד חשיבות וקדושה של עשרה שהם עדה רק שהם הם המכונים ונקראים העדה המיוחדת לכל רע ככתוב בצדו שם אשר הצו וגו', והם הם השני עברים נצים והם שהותירו מן המן וכיוצא בזה כמעט היו בכל רע ומחזיקים ביותר במחלוקת מכל העדה, הרי שלגריעותא הם קרואים עדה לא לשבח ולקדושה של יו"ד, לכן קרינן ביו"ד דעכ"פ לענין עדה של עשרה קמיירי שהם קרואים עדה אבל לא כתיב ביו"ד מפני שהוא לגריעותא):	Numbers 1:16
Paaneach Raza, Bamidbar 19	ויהיו בני ראובן בכור ישראל בא ליתן טעם בזה שנמנאו ראשון דמהראוי הי' למנות יהודה תחלה שהי' ראשון במסע הדגלים, אלא מפני שזה הוא בכור ישראל:	Numbers 1:20
Paaneach Raza, Bamidbar 20	בכר ישראל חסר ו' כתיב, כי בחללו יציעי אביו נחסרה ממנו בכורה לענין ליטול פי שנים בארץ וניתנה ליוסף:	Numbers 1:20
Paaneach Raza, Bamidbar 21	לבני יוסף לבני אפרים, כפל מלת לבני לרמוז כי מהראוי הי' ליוסף דגל לעצמו אלא שמפני שלהיותו מלך לא טען בארון אביו ולא עסק בו לא ניתן לו דגל:	Numbers 1:32
Paaneach Raza, Bamidbar 22	בכולן כתיב לבני חוץ מבנפתלי כתיב בני מפני שבנותיו היו מרובין מבניו, וכן רמז יעקב בברכותיו נפתלי "אילה "שלוחה "הנותן וגו' ר"ת אש"ה, וכן מטעם זה כתיב בפ' פנחס בכולם בני בני ולא לבני, משום שהרי כשמתו מתי מדבר אנשים מתו ולא נשים א"כ היו אז נשים הרבה מאד מאנשים:	Numbers 1:32
Paaneach Raza, Bamidbar 23	איש על דגלו אי"ש בגימט' שב"ט איש לבית אבותיו ולא אשה לבית אבותיה כי היא נגררת אחר בעלה:	Numbers 1:32
Paaneach Raza, Bamidbar 24	באותות לבית אבותם פי' באותות שמסר להם יעקב, לראובן היו מצויירים דודאים, ליהודה אריה, ליששכר חמור, לדן נחש, לבנימין זאב, ליוסף למנשה שור, לנפתלי אילה, לשמעון כלי חמס, לגד לביא שכן, לאשר עץ זית, לזבולון אניה בלב ים, לאפרים קרני ראם, מהר"ר תיט"ב:	Numbers 1:32
Paaneach Raza, Bamidbar 25	והלוים לא התפקדו וגו' מפני כי מנינם לא הי' שוה לזה, דאלו נמנו מבן כ' ולוים מבן חודש, ותימה איך אפשר שאע"פ שנמנה להם כל זכר מבן חודש ומעלה לא הי' כי אם כ"ב אלף, בשלמא לאחר שהוקם המשכן הי' מכלה בם הארון אבל במנין ראשון איך היו כ"כ מעט, וי"ל דגם מתחלה כיון שלא היו בכלל שיעבוד לא היו ג"כ בברכת כן ירבה, (מבן" עשרים" שנה" ס"ת המ"ן כי המן נתכוין לשקול כנגד כל ישראל:	Numbers 1:47-48
Paaneach Raza, Bamidbar 26	אך את מטה לוי אכי"ן ורקי"ן מיעוטין לפי שהארון מכלה בהם:	Numbers 1:49
Paaneach Raza, Bamidbar 27	ואת ראשם לא תשא, שלא ילכו בקומה זקופה משום אימת שכינה שעליהם אלא שייף ועייל שייף ונפיק):	NULL
Paaneach Raza, Bamidbar 28	ואלה תולדות אהרן ומשה נקרא ג"כ ע"ש משה כיון שהוא למדם תורה:	Numbers 3:1
Paaneach Raza, Bamidbar 29	ביום דבר ה' את משה פי' אז היו אלה ארבעתן תולדות אהרן, אבל אח"כ מתו השנים:	Numbers 3:1
Paaneach Raza, Bamidbar 30	הבכור נדב, הבכר חסר וי"ו לפי שאמרו איזה אשה הוגנת לנו ולכך לא הי' להם בנים, ומה שמתו נדב ואביהוא מפני שכתוב במשפטים ונגש משה לבדו ולא הזקנים ואהרן ובניו ואלו עברו ונגשו כדכתיב ויראו את אלהי ישראל, לכן נגזר אז עליהם שיהיו נשרפים (ודוקא שריפה כי אש אוכלה הוא):	NULL
Paaneach Raza, Bamidbar 31	על פני אהרן אביהם, נראה דקאי ארישא דקרא אמה שכתוב וימת נדב ואביהוא וגו' וכמו וימת הרן על פני וגו', ג"ן:	NULL
Paaneach Raza, Bamidbar 32	ושמרו את כהונתם, שאפי' הלוים לא יקרבו אל המזבח ואל כלי הקודש דהא זרים הם לגבי כהונה, ר' יוסף קרא:	NULL
Paaneach Raza, Bamidbar 33	אשר פקד משה ואהרן נקוד על אהרן לומר כאלו הי' טעות כאן דלמשה לבדו צוה הקב"ה פקוד את בני לוי ולא כפקודי ב"י שעליו אמר לו תפקדו אותם אתה ואהרן ומשה חלק לו כבוד ונטלו עמו גם בזה, תיט"ב:	NULL
Paaneach Raza, Bamidbar 34	שנים ועשרים אלף, וקשה הרי בפרטן נמצאים יותר, וי"ל דבפרטן מונה גם בני לויה נקבה שנשאת לישראל ונ"מ לפטרו מפדיון הבן ולכן בפרטיהן לא אמר במקצתן לבית אבותם, דהנהו לוים מצד האם היו:	NULL
Paaneach Raza, Bamidbar 35	ולקחת חמשת חמשת שקלים, פי' כל הבכורות שמכאן ולהבא, וא"ת הבכורים הנולדים מאלו הבכורים העודפים מכאן ולהבא למה לא יהו פטורים מבכורה כמו הלוים הנולדים מכאן ולהבא מן הלווים שפטורים מן הבכורה, וי"ל שאין ידועים איזה הם העודפים לכן צוה הקב"ה לפדות כל הבכורות שיוולדו מכאן ולהבא, ג"ן:	NULL
Paaneach Raza, Bamidbar 36	ושמו בדיו, וקשה והכתיב לא יסורו ממנו וי"ל דודאי לא היו נשמטים ממנו לעולם דראשיהם היו גסים, אבל היו הולכים ובאים בטבעות עד ראשיהם בחנייתם, ובנסיעתם צוה ושמו שיהיו מהדקים אותן שלא יוכלו אז להמשך הנה והנה:	NULL
Paaneach Raza, Bamidbar 37	סליקא לה פרשת במדבר, ברוך שאמר אל שני קצותיו וחבר:	Numbers 3:2
Paaneach Raza, Nasso 1	@במדבר פרשת נשא	NULL
Paaneach Raza, Nasso 2	ובעזר מושל בגאות הים בשוא, נתחיל סדר נשא:	NULL
Paaneach Raza, Nasso 3	נשא את ראש בני גרשון גם הם לפי שהוא ראשון וגדול לבני לוי כדכתיב ובני לוי גרשון קהת ומררי והי' ראוי למנותו תחלה לולא שנמנה קהת תחלה לפי קדושת עבודתו אשר בכתף ישאו הארון ומנורה ומזבחות, לפיכך אומר כאן גם הם כלומר אע"פ שצויתי למנות קהת תחלה לטעם הנזכר מ"מ ימנו גם בני גרשון ופתח להם בזה סדר מיוחד לחשיבותם:	Numbers 4:22
Paaneach Raza, Nasso 4	וישלחו מן המחנה וגו' נסמכה פ' שילוח טמאים לפרשת דגלים ומשא בני לוי דמכיון שסדרו הדגלים ושכינה ביניהם הוצרכו לזה:	Numbers 5:4
Paaneach Raza, Nasso 5	אשר יקריבו לכהן לו יהי' לכהן שבאותו משמר שאין כהני משמר אחר חולקין עמו:	Numbers 5:7-8
Paaneach Raza, Nasso 6	ולנפל ירך, חסר ו' כתיב ולנפל כדי לקרותו לנפל שהיו משקין אותה אף כשהיתה מעוברת ולא חיישינן שמא יעשה נפל כדאמרינן בפ' ארוסה מעוברת עצמן או שותות או לא נוטלות כתובה:	Numbers 5:22
Paaneach Raza, Nasso 7	ואמרה האשה אמן אמן, אחד על לצבות בטן וא' על לנפיל ירך:	Numbers 5:22
Paaneach Raza, Nasso 8	ולק"ח הכה"ן מי"ד האש"ה בגימט' אב"ל ל"א יק"ח מי"ד השלי"ח:	Numbers 5:25
Paaneach Raza, Nasso 9	אי"ש א"ו אש"ה כי יפליא בגימט' מופל"א סמו"ך לאי"ש מיי"ן ושכ"ר יזי"ר בגימט' ה"ו שמשו"ן ב"ן מנו"ח:	NULL
Paaneach Raza, Nasso 10	כ"י יפל"א בגימט' בב"ל אונ"ס:	NULL
Paaneach Raza, Nasso 11	מאשר חטא על הנפש פי' שהי' באהל אשר על נפש המת כאשר הוזהר בסמוך על נפש מת לא יבא, זהו לשון על, הר"ר יאיר:	Numbers 5:30
Paaneach Raza, Nasso 12	ד"א מאשר חטא, לשון חסרון כמו קולע אל השערה ולא יחטיא ודומהו, ופירושו שציער וחיסר נפשו מן היין, ג"ן:	Numbers 6:2
Paaneach Raza, Nasso 13	ובפ"ג דנזיר אמרו מזה ק"ו על היושב בתענית שנקרא חוטא דהשתא זה שלא ציער עצמו אלא מן היין נקרא חוטא המצער עצמו מכ"ד עאכ"ו. והקשה הר"ר אליעזר ממיץ דהא איכא למפרך מה לנזיר שסתם נזירות ל' יום אבל זה אינו יושב בתענית אלא יום א', וי"ל דמ"מ איכא ק"ו דבתענית צערי' טובא:	NULL
Paaneach Raza, Nasso 14	גדל פרע, פירש"י ואין פרע אלא ל' יום, וקשה הא אמרינן התם סתם נזירות ל' יום כדכתיב קדוש יהיה גדל וגו' יהי"ה בגימט' ל' ול"ל א"כ יהי' כיון שאין נקרא גידול שער בפחות מל' יום:	Numbers 6:5
Paaneach Raza, Nasso 15	כה תברכו את ב"י אמור להם תרגומו כד יימרון להון, מכאן שאין כהן עובר בעשה אם אינו עולה לדוכן אא"כ אומרים לו לעלות ומסרב ואינו עולה ובמדרש יש שמכאן דכתיב אמור להם שהש"ץ מקרא את הכהנים כל תיבה ותיבה וקורא תחלה כהנים אבל לא לכהן אחד כמשמעות אמור להם, לרבים דוקא:	Numbers 6:23
Paaneach Raza, Nasso 16	כה תברכו, שמעתי שבספרים מדוייקים כתיב כוה מלא בוי"ו ע"ש שהכהנים יעשו ידיהם כמין חלון ע"ש מציץ מן החרכים, זהו כוה מלשון וכוין פתיחן לי' וגו', מהר"ר אהרן הצרפתי:	Numbers 6:23
Paaneach Raza, Nasso 17	אמו"ר לה"ם בגימט' וחז"ן יאמ"ר אמור מלא כדי שיהי' בגימט' זמר לומר שמנגנין אותו בנעימת זמר, ד"א מלא ו' כנגד ו' ברכות, יברכך, וישמרך, יאר, ויחנך, ישא, וישם לך שלום:	Numbers 6:23-24
Paaneach Raza, Nasso 18	לה"ם, בגימט' כה"ן, (והוא רמז שכהן יחידי העולה לדוכן לא יקראנו הש"ץ תחלה כהן דזהו רמז המספר כאלו הי' כתוב אמור כהן כלומר שהכהן יחידי הוא יאמר מעצמו ולא שיצונו הש"ץ תחלה לומר כמשמעות פשוטו של אמור להם שהוא הוראה לש"ץ לקרות כהנים כנזכר לכן כשנעשה לה"ם למספר כה"ן הרי משמעות זה בטל, ומשמע כהן אמור), סיים ברכת כהנים בשלום משום דאמרינן בשלהי עוקצין אין לך כלי מחזיק ברכה אלא השלום שנאמר ה' עוז לעמו יתן ה' יברך את עמו בשלום, גן, מרבי:	NULL
Paaneach Raza, Nasso 19	כה תברכו, ותימה מאי נ"מ מברכת כהנים, דלמאן נינהו אי לצדיקים לא אצטריך דכבר כתיב אם בחקותי תלכו וגו' ובאו עליך כל הברכות, אם לרשעים הרי נאמר עליהם ובאו עליך כל הקללות, וי"ל דנ"מ לצדיקים לענין שלפעמים יש מי שלפי מזלו ומערכתו דבקין בו הקללות שמקללין אותו זולתו ומתקיימי' בו אף אם הוא צדיק והמקלל רשע, לכן יקדמו לו ברכת כהנים שלא ישלטו בו אח"כ קללות הרשעים, מצאתי:	NULL
Paaneach Raza, Nasso 20	(ול"נ דודאי נ"מ לצדיקים כפשטי' דעכ"פ צריך התעוררות בתחנונים לעורר כח ברכות עליונים ולכן אמר כה תברכו וגו' והדר ואני אברכם, ועוד דנ"מ דעי"כ שניהם מתברכין מהש"י המברך והמתברך כדכתי' ואברכה מברכך שהכהנים גם הם מתברכים וכדעה האחת ברש"י ז"ל על ואני אברכם):	NULL
Paaneach Raza, Nasso 21	"ושמו "את "שמי ר"ת למפרע שא"ו, על שם שאו ידיכם קודש וברכו את ה' (והרמז לדעתי בא בר"ת מפני שבתחלה ישאו ידיהם קודם שמברכין הברכה שלפניה, זהו ג"כ שאו ידיכם קודש תחלה והדר וברכו את ה' ואע"ג דבכל המצות צ"ל הברכה עובר לעשייתן, הוא הוא דנשיאת הידים לא הוא מהמצוה אלא לברך את ב"י הוא הוא המצוה וא"כ שפיר עובר לעשייתן הוא, רק שטוב יותר לישא הידים תחלה לכונת הורדת השפע מן העשר, גם להכין עצמו תחלה לכך, כי לכ"ד צריך הכנה תחלה וכ"ש לדבר קדושה כזו, ומה שבא הרמז למפרע הוא ללמדנו עוד שיהיו פני הכהנים תחלה על היכל ה' ואח"כ כשקורא הש"ץ יסבו בלכתן ויהפכו פניהם למפרע וישאו את ידיהם, לכן נרמז אותיות שאו למפרע שנשיאה תהי' כשהופכי' את פניהם למפרע, וממילא שמעינן שמתחלה יהיו פניהם שלא אל המברכים, והכל כאשר אנו נוהגים ומכאן אנו למדין):	Numbers 6:26-27
Paaneach Raza, Nasso 22	ויהי ביום כלות משה, נסמכה פ' חנוכת המזבח לברכת כהנים לומר, יבאו ישראל שהתנדבו ט"ו דברים ועשו מהם המשכן ויקבלו ברכת כהנים של ט"ו תיבות:	Numbers 7:1
Paaneach Raza, Nasso 23	כלת משה, פירש"י בצלאל וכל חכם לב עשו את המשכן ותלאו הכתוב במשה לפי שמסר נפשו עליו וכו' וקשה הא מיירי הכא בהקמת המשכן ומה לבצלאל וכל חכם לב לזה הרי משה הקימו ופרקו וחזר והקימו כפי' רש"י עצמו בסמוך, מהר"ר יעקב:	Numbers 7:1
Paaneach Raza, Nasso 24	(ול"ק כלל דרש"י דקדק מדזכר הכתוב כאן ההקמה שעשה משה ולא כל העשיי' שנעשית ע"י בצלאל וכל חכם לב לא נזכר כלל והכי הול"ל ויהי ביום כלות המשכן והקמתו כדי לכלול גם העשיי' אלא ודאי דנקט של משה לבד כדי לתלות בו):	NULL
Paaneach Raza, Nasso 25	עגלות צב, פי' נפוחים במפח הכסוי שענינו רכב עגלה המכוסה כעין שרוכבין בו שרים ושרות, וכן תרגומו כד מחפיין וכפירש"י והי' זה לכבוד כלי הקודש והקדשים, והנה הוא מלשון הצב למינהו וכמו לצבות בטן, וכן בצבים ובפרדים, ד"א צב לשון מעמד כמו מוצב ארצה, וענינו שיכולין לעמוד על עמדם ולא תשברנה ממשאם, (ד"א צב כמו צבא ופי' עגלות הצבא בל"א הע"ר וועגין שעושין אנשי הצבא כמוהם להוליך בהם כליהם ומשאיהם ומאכלם):	Numbers 7:3
Paaneach Raza, Nasso 26	וקרבנו, וי"ו יתירה שאותו היום ראתה אלישע בת עמינדב ו' שמחות ובתוכם שאחיה נחשון נשיא ובכולם כתיב נשיא חוץ מבנחשון למטה יהודה מפני שיהודה הי' תופס במדת ענוה ולא נהג עצמו בנשיאות וכדכתיב ישב נא עבדך תחת הנער, (ואני אומר מפני גדולתו הגדולה מזו המוכנת לו דהיינו המלכות לא נכתב לגבי שבטו נשיאות, ובזה גם ייתור ו' מתיישב מ"ש וקרבנו אשר גם התיבה בכללה מיותרת דהיל"ל ויהי המקריב ביום הראשון נחשון בן עמינדב למטה יהודה, קרבנו קערת כסף וגו' כדכתיב בכל הנך, ול"ל תרתי את קרבנו וקרבנו, אלא שרמז בזה תוספות קירוב והקרבה אשר מיוחדת לו לבדו מכל זולתו שהוא נקרב גם למלכות בשביל שקירב א"ע אל השי"ת וקידש שמו בפרהסיא ושלכך נתקרב בשמו כל שם בן ד' כולו):	NULL
Paaneach Raza, Nasso 27	שלשים ומאה משקלה נגד משה שילדתו יוכבד בת ק"ל שנה:	Numbers 7:13
Paaneach Raza, Nasso 28	שבעים שקל נגד ע' סנהדרין:	Numbers 7:13
Paaneach Raza, Nasso 29	בלולה בשמן נגד מרים שנבללה ברוח הקודש:	Numbers 7:13-14
Paaneach Raza, Nasso 30	(כף אחת עשרה זהב ומלאה קטורת נגד אהרן אשר כפו וידו לבדה מקרבת הקטרת לכן עשרה זהב כי יו"ד נקראת ע"ש יד ושם כדאיתא באותיות דר"ע, לכן דוקא זהב העולה כמנין י"ד וכמנין וד"י זה"ב:	Numbers 7:14
Paaneach Raza, Nasso 31	פר אחד איל אחד כבש אחד שעיר עזים אחד נגד ד' חלקי השבטים אשר מארבע אמותם וכנגד ד' האמהות:	Numbers 7:15
Paaneach Raza, Nasso 32	ולזבח השלמים בקר שנים נגד אדם ונח שנוצרו ונולדו שניהם שלמים ותמים ואין להאריך לכוון כלל הדברים ובאמת נכונים המה במעט העיון):	Numbers 7:17
Paaneach Raza, Nasso 33	אילים חמשה עתודים חמשה כבשים בני שנה חמשה נגד אברהם יצחק ויעקב שקיימו שלשתם כל הכתוב לחיים בה' חומשי התורה:	Numbers 7:17
Paaneach Raza, Nasso 34	ויהי ביום עשתי עשר, פי' ע"ד שתי עשר ולא עד בכלל, ד"א לשון אולי יתעשת, אבדו עשתונותיו, כלומר לחשוב חשבונות שעתה מתחיל להוסיף חשבון נוסף על עשרה דהיינו אחד עשר שהוא הראשון המתחיל להיות בו מותר על חשבון עשרה, זהו עשתי עשר שבכאן מוסיפין חשבון על עשרה:	Numbers 7:72
Paaneach Raza, Nasso 35	ובבא משה וגו' פי' דאלו כשהוא בחוץ כתיב וידבר אליו מאהל מועד לאמר כאדם שעומד מחוץ לבית ושומע קול מתוכו אינו יודע במכוון מאיזה מקום שבאהל הקול בא, אבל בבאו אל אהל מועד הבין והרגיש שהקול בא מבין הכרובים:	Numbers 7:89
Paaneach Raza, Nasso 36	"מבין "שני "הכרובים ר"ת מש"ה, שהי' משה שקול ככרובים של מעלה (ולכן באו האותיות בר"ת לרמז שחשוב הוא ככרובים הראשיים העליונים לא לבד כאלו שעל הכפורת או שחשוב הוא יותר מהם והוא בראשם):	Numbers 7:89
Paaneach Raza, Beha'alotcha 1	@במדבר פרשת בהעלותך	NULL
Paaneach Raza, Beha'alotcha 2	ובעזר ה' קויתי לישועתך, נתחיל סדר בהעלותך:	NULL
Paaneach Raza, Beha'alotcha 3	בהעלותך, נסמכה פרשת נרות לחנוכת המזבח וע"ז סמכו בית חשמונאי לתקן נרות בחנוכה:	NULL
Paaneach Raza, Beha'alotcha 4	את הנרות, הכלי בית קבול הנקראים נרות עליהם אמר בהעלותך אותן שהכהן הי' מטלטלן ומעלה אותן בעת ההדלקה לקובען במנורה כי אינן מגוף המנורה, דלכך כתיב עד ירכה עד פרחה מקשה היא לאפוקי הנרות שאינן מחוברות ומעשה מקשה, ואל"כ מה לו להזכיר כאן בענין ההדלקה ירכה ופרחה:	NULL
Paaneach Raza, Beha'alotcha 5	אל מול פני המנורה וגו' לפי פשוטו יש לפרש שזהו השלחן שהוא מול פני המנורה כדכתיב ושמת את המנורה נוכח השלחן וא"כ הרי כל ז' הנרות היו פונים נכח השלחן, הר"ר מאיר:	Numbers 8:2
Paaneach Raza, Beha'alotcha 6	והעבירו תער, פירש"י בשם ר' משה הדרשן מפני שנתנו כפרה על הבכורות שעבדו ע"ז והיא קרוי' זבחי מתים וכו', וקשה נהי דע"ז קרוי' מת מ"מ עובדיהם לא מצינו שקרוים הכי לכן י"ל דבספרי דרשו בשעה שעשו את העגל נעשו מצורעים כדכתיב כי פרוע הוא ולכך אלו שניתנו תחתיהם הוצרכו לתגלחת כמצורעים:	Numbers 8:7
Paaneach Raza, Beha'alotcha 7	מצאתי:	NULL
Paaneach Raza, Beha'alotcha 8	ולא יעבוד עוד, פירש"י עבודת משא בכתף וכו', הקשה הר"ר יעקב א"כ למה גם בני גרשון ומררי לא נמנו אלא עד חמשים הרי הם לא עבדו במשא הכתף וא"כ הם אינם נפסלים בשנים, ועוד הא אמרו בפ"ק דחולין יכול אף בשילה כן, פי' שינהוג פסול שנים ת"ל לעבוד עבודת עבודה ועבודת משא, לא אמרתי אלא בזמן שעבודה בכתף, הרי משמע דבזמן עבודת משא אף שאר עבודות פסולים בשנים. ועוד הקשה הר"ר חיים על מה שפירש"י אבל חוזר הוא לנעילת שערים ולשיר וכו' דמשמע לקול אינן נפסלים בשנים וכן איתא בספרי והאמר בפ"ק דחולין ה"מ באהל מועד משמע שם דבאהל מועד אף לקול נפסלים, ותירץ דלא גרסינן לא בספרי ולא ברש"י לשורר, מרבי:	Numbers 8:25-26
Paaneach Raza, Beha'alotcha 9	בחדש הראשון, פירש"י ולמה לא פתח בזו מפני שהוא גנותן וכו', וא"ת מה גנאי יש שלא הקריבו פסחים במדבר הלא תלאו הכתוב בביאתן לארץ וי"ל דודאי גנאי הוא להם דאם זכו היו נכנסין בשנה שניה לארץ ועושין פסחיהם בכל שנה ושנה, ג"ן:	Numbers 9:1-2
Paaneach Raza, Beha'alotcha 10	ויהי אנשים אשר היו טמאים לנפש אדם דהיינו לנדב ואביהוא וי"מ למת מצוה דהיינו אותן שנשאו ארונו של יוסף:	Numbers 9:6
Paaneach Raza, Beha'alotcha 11	אש"ר הי"ו טמאי"ם בגימ' למת מצוה:	Numbers 9:6
Paaneach Raza, Beha'alotcha 12	ויהי ולא כתיב ויהיו לשון רבים כי לא הי' רק מישאל לבדו לנדב ואלצפן לבדו לאביהוא, ד"א ויהי יחיד נדחה ואין צבור נדחין:	NULL
Paaneach Raza, Beha'alotcha 13	בדרך רחוקה, נקוד על ה"א ע' לעיל פ' וירא אצל נקוד על אין:	Numbers 9:10
Paaneach Raza, Beha'alotcha 14	ויש אשר יהי' הענן ימים מספר וגו', סותם ואח"כ מפרש, דהיינו ויש אשר יהי' הענן מערב עד בוקר וגו' או יומם ולילה וגו' או יומים וגו' כל אלה פירושו דקרא קמא הוא, או יומם ולילה וגו' פי' או יומם או לילה כמו אביו ואמו שפי' או אמו, ונ"מ שלפעמים הי' ג"כ הענן על האהל יומם לבד ואח"כ נעלה באופן שנסעו אז בלילה, כי ע"כ גם בלילה הי' לפעמים מסע כדכתיב ואש תהי' לילה בו לעיני כל ישראל בכל מסעיהם ולא כתיב בכל חנייתם מכלל דגם בלילה נסעו:	Numbers 9:20
Paaneach Raza, Beha'alotcha 15	עשה לך שתי חצוצרות וגו', בתנחומא איתא לך לצרכך כדי שיתקעו לפניך כמלך וכשמת משה נגנזו ולא הי"ל במה לאסוף את ישראל, וראי' לזה כשצרו על יריחו לא מצינו להם כ"א שופרות, ותימה דבסמוך כתיב כי תבאו מלחמה בארצכם וגו' והרעותם בחצוצרות וגו' והרי בשעת ביאתם לארץ לא היו חצוצרות, וי"ל דבספרי אמרו וכי תבאו מלחמה בארצכם במלחמות גוג ומגוג הוא מדבר, א"נ של משה נגנזו ואחריני הוו להו (וביריחו אולי הוראת שעה היתה לתקוע בשופרות):	Numbers 10:2
Paaneach Raza, Beha'alotcha 16	מאסף לכל המחנות, פי' מפני שהוא אחרון, וכל שנסוג אחור ומתעכב על איזה דבר הוא מתעכב עמו ומאספו, זהו מאסף לכל המחנות, שהוא מאסף לכל השבטים ואין אחר מהשבטים מאספו, ג"ן:	NULL
Paaneach Raza, Beha'alotcha 17	אל נא תעזוב אותנו כי על כן וגו', פי' שמה שלא בקשנוך עד עתה הוא על כן כי ידעת חנותינו במדבר ולא הי' לנו במה להטיב לך, כי אנחנו בעצמנו מהנסים והגבורות שעשה לנו המקום חיינו ואכלנו, אבל עתה נוסעים אנחנו וגו' והטבנו לך כי יהיה בידינו לכבדך, והיית לנו לעינים, פי' למראות העין, כי כל הרואה יעיד ויאמר לא לחנם עזב יתרו כל ארצו וגדולתו אם לא הי' רואה טובתו של הקב"ה וגדולתו שעושה עמהם:	Numbers 10:30
Paaneach Raza, Beha'alotcha 18	ד"א והיית לנו לראש, כמו על אבן אחת שבעה עינים, שפי' שבעה ראשים, כלומר וכדי למהר בנין בהמ"ק, והר"ר יוסף פירש והיית מאיר עינינו בעצתך הנכונה כמו שמע בקולי איעצך וגו', ד"א להורות לנו עינים ודרכים כי אתה יודע מבואן ומוצאן, הר"ר אליעזר:	Numbers 10:31-32
Paaneach Raza, Beha'alotcha 19	ויהי בנסוע וגו', הנו"ן הפוכה, לומר כי נסעו והלכו אחור ולא פנים שלולא שחטאו היו נכנסין לארץ בג' מסעות, תיט"ב:	Numbers 10:35
Paaneach Raza, Beha'alotcha 20	ועוד לפי שחטאו לא עברו אז הירדן שרחבו נ' אמה לכן הנו"ן הפוכה:	NULL
Paaneach Raza, Beha'alotcha 21	ד"א עשה סימניות לומר שאין זה מקומו רק לעיל אחר ונסעו הקהתים והקימו את המשכן עד בואם, לכן היא הפוכה לאחוריה להשתוקק לעמוד אחר המ"ם של בואם כמו מקומה באלפ"א בית"א, והשניה הפוכה להסמיכה לונסע דגל מחנה ואז יהי' נו"ן מלאה ואח"כ ס' ע' כי אם תשים נ' אל ונסע יהי' נו"ן ס"ע ויהי' א"כ ג"כ כפי סדרה באלפ"א בית"א:	NULL
Paaneach Raza, Beha'alotcha 22	בנס"ע בגימט' יעק"ב כי צורתו חקוקה בכסא והרי המרכבה והשכינה נוסעים עמהם:	NULL
Paaneach Raza, Beha'alotcha 23	ובנחה, כתיב בה"י יתירה על ה' דברים שחנו ונחו בכל עת החניי', דהיינו ד' דגלים, ומחנה שכינה שהוא הארון והלוים באמצע:	NULL
Paaneach Raza, Beha'alotcha 24	ויהי בנסוע, אמרו רבותינו שזהו ספר בפ"ע ולכך י"ב תיבות בפסוק כמו בפסוק ולכל היד החזקה שהוא סיום ספר לעצמו [התורה] לומר שזהו ספר לעצמו כמו משנה תורה, וא"כ ז' ספרים בתורה ע"ד חצבה עמודיה שבעה, ולכן ז' תיבות בפסוק ובנחה, ועוד משום דמיון פסוק בראשית, לומר שגם זה לעצמו כספר בראשית:	NULL
Paaneach Raza, Beha'alotcha 25	כמתאוננים פי' כאוננים, לשון אנינות שהתאבלו על שהקב"ה רצה להכניסם לארץ מהרה כפירש"י לעיל בסמוך, ודאגו ממלחמות כי קטני אמנה וקצרי רוח היו:	NULL
Paaneach Raza, Beha'alotcha 26	ותאכל בקצה המחנה, פי' ר' שמעון בן מנסיא אומר בקצינים וגדולים שבהם והן הסנהדרין, ולכך אמר דוד ותבער אש בעדתו ועדה זו סנהדרין:	Numbers 11:1-2
Paaneach Raza, Beha'alotcha 27	את הדגה, בפרק בתרא דיומא פי' שהזמין להם הקב"ה דגים בכליהם וקשה מה ענין זה אצל אבטיחים וקישואים, ותירץ מהר"ר משה לפי שהנילוס הי' משקה השדות וחוזר לו ונשארו דגים בשדות וגנות של קישואים ואבטיחים:	NULL
Paaneach Raza, Beha'alotcha 28	כטעם לשד השמן וכתיב כצפיחית בדבש. דקודם שנידוך הי' כצפיחית ולאחר שנידוך כטעם לשד השמן, לשד השמ"ן אותיות משנ"ה, שטעמו הי' כפול כלשד, פי' רי"ח:	Numbers 11:8-9
Paaneach Raza, Beha'alotcha 29	בוכה למשפחותיו, פירש"י ורבותינו אמרו על עסקי משפחות, על עריות ותימה א"כ בשעת מתן תורה כשנצטוו על העריות הי"ל לבכות, וי"ל שלא רצו לערבב השמחה אז (ולי נראה דדוקא עתה שהתאוו תאוה במאכל ומשקה משם נפרדו ונכנסו לסוג הב' של התאוה שהוא המשגל:	Numbers 11:10
Paaneach Raza, Beha'alotcha 30	כי תאמר אלי כלומר כי לולא שאמרת לי הייתי בורח לי:	NULL
Paaneach Raza, Beha'alotcha 31	ואל אראה ברעתי פי' שמוטב למות מיד כאחד מלהיות מתנונה והולך בידם, ג"ן:	NULL
Paaneach Raza, Beha'alotcha 32	(וזהו ג"כ הרגני נא הרוג, שאמר הרגני, אבל באנא ומטו נא הרוג, כלומר מהר ועתה תיכף כי נא הוא לשון מהר כרבים חבריו, ותרגומו כען כלומר שיברור לו מיתה יפה למות מהר וזהו אם מצאתי חן בעיניך. והטעם ימשך בנגינתו תיבת נא לתיבת הרוג):	NULL
Paaneach Raza, Beha'alotcha 33	ויאמר משה שש מאות אלף רגלי וגו', תימה היאך עלה ע"ד משה שאין סיפוק בידי שמים כביכול, ורבינו נסים גאון פי' שיטת הפסוקים כך, שש מאות אלף רגלי וגו' כלומר בודאי אם בהיותם אלף פעמים כאלה יש יכולת בידך אבל אתה אמרת הדבר בריתחא וכעס כדכתיב עד חודש ימים עד אשר יצא מאפכם ואמרת ליתן להם כזאת ביום א', וע"ז אמר הצאן ובקר ישחט להם, להם דייקא כלומר מצדם ימנע, כי איך יספיקו לשחוט ולהזמין להם ביום א' על חודש ימים, והשיב לו הקב"ה היד ה' תקצר וכמו שזה בידי כן בידי שיתקיימו דברי, וזהו ויטש על המחנה וגו' שלא היו צריכים אפי' להושטת יד, כך שמע הג"ן מפי מהר"ר משה בר שניאור ז"ל, ויש לפרש בענין אחר דבניחותא קאמר משה הצאן ובקר שאלו ודאי ישחט להם וכן אם דגי הים שאלו ודאי יאסף להם, אבל הם לא מאלו שאלו, כי אם בשר עוף מה שאינו בידי להגיעם, והשיב השי"ת על שאלתם היד ה' תקצר וכו' סבורים היו הם שאין יכולת בידי עד שלכן שאלו דוקא כזאת, וח"ו לא עלה ע"ד משה לדבר סרה עליו ית', ד"א שבשר תאוה נאסר להם, ותמה משה הלא אין לנו אלא ג' כהנים בעולם אהרן ושני בניו ואיך יספיקו אלו לשחוט להם, וככה בדוגמא זאת אם כל דגי הים יאסף להם שאפי' לאסיפת דגים לבד לא יספיקו ג' אנשים, ואמר הקב"ה היד ד' תקצר שאתן להם בשר אשר אין בו צורך לכהנים, וזהו ויגז שלוים, מהר"ר מש"ה:	Numbers 11:21
Paaneach Raza, Beha'alotcha 34	(ד"א שכל כונת משה היתה לומר כי בעלילה הם באים, וזהו הצאן ובקר ישחט, פי' גם אם תתן להם כל צאן ובקר שבעולם לא יספיק להם, כי אז יפנו לבקש תואנה אחרת כגון דגים, וכן אם כל דגי וגו' בתמי', וכי בזה תנוח דעתם, וכי לא יוכלו עוד אח"כ לבקש ד"א וכן לעולם לא יספיק להם כי מכוונים הם להמריד, וזהו הצאן ובקר ישחט להם כלומר וכי תכליתם לשיהא נשחט להם צאן ובקר לא זו הדרך דרכם וכונתם, וזהו שש מאות אלף וגו', ואתה אמרת וגו', אבל הם אינם מתיישבים בזה כי לעולם יבקשו עוד תואנה כנזכר, והשיב הקב"ה היד ה' תקצר, וכל שישאלו זא"ז הכל הייתי נותן כדי שלא ימצאו אחרי מאומה, אבל באמת והבשר עודנו בין שיניהם וגו', שלא הספיק להם בכדי שישאלו דבר אחר עוד עד שלקח מהם נקמתו ית'):	Numbers 11:23-24
Paaneach Raza, Beha'alotcha 35	ויגז שלוים, נראה לרבינו בכור שור שזהו אותו שליו הנזכר בפ' בשלח, רק דאיידי דאיירי התם במן נקט נמי שליו, וע"כ אנו צריכים לומר כן דאלו הי"ל שליו כבר איך תמה משה הצאן ובקר ישחט אלא שהוא הוא:	Numbers 11:31
Paaneach Raza, Beha'alotcha 36	אלדד ומידד הם בני עמרם מאשה אחרת, שכשנתן הקב"ה התורה פירש מיוכבד שהיתה דודתו ונשא לו אחרת והוליד ממנה את אלו:	NULL
Paaneach Raza, Beha'alotcha 37	אדוני משה כלאם וקשה למה הקפיד יהושע כ"כ, וי"ל לפי שכל הנביאים נבאו באה"מ ונטלו רשות ממשה שנאמר ולקחת אותם אל אהל מועד והתיצבו שם עמך והם לא נטלו רשות, גם היו חוץ לאהל מועד, והשיב משה מי יתן וגו' בין באהל מועד בין חוצה לו רק יקל מעלי המשא:	NULL
Paaneach Raza, Beha'alotcha 38	הבשר עודנו בין שיניהם פי' אחר שהספיקו כולם לאכול ממנו כדי שלא יאמרו מבלתי יכולת ה' להספיק כולם נגף אותם:	Numbers 11:33
Paaneach Raza, Beha'alotcha 39	ראיתי במדרש תהלים שהרג השמנים והבריאים שבהם שאותן שאלו שלא כהוגן מתוך כרס מלאה. אבל הכחושים עשו להבריא א"ע, ג"ן:	NULL
Paaneach Raza, Beha'alotcha 40	(לפ"ז אמר הבשר עודנו בין שיניהם על בשר גופם בעצמם כלומר אלו שהיו כבר בעלי בשר ושמנים שאלו ומכאן לקחו המדרש):	Numbers 12:1
Paaneach Raza, Beha'alotcha 41	ותדבר מרים ואהרן הקדים אותה לפי שהנשים דברניות הן והיא החזיקה בדבר יותר:	Numbers 12:1
Paaneach Raza, Beha'alotcha 42	על אודות האשה הכשית וגו', פי' הר"ר אהרן שאמרו למה פירש ממנה בשביל שהיא כעורה, הלא היתה כן כשנשאה ולמה לא הניחה, מתחלה סבור וקבל, זהו כי אשה כושית לקח, שגם זה מדבריהם שאמר הלא כושית לקחה וא"כ יחזיקנה, והג"ן מפרש שאמרו שע"י שנתגאה ממה שנדבר עמו הש"י לקח אשה כושית אשר לא מבנות ישראל היתה שהיו בנות ישראל בזויות ושפלות בעיניו ובחר לו בבת מלך כוש:	NULL
Paaneach Raza, Beha'alotcha 43	הלא גם בנו דיבר וגו', ולא נתגאינו בכך, ונראה דלא על צפורה אמרו כך דאותה לקח באונס הבריחה כי בורח הוא מחרב פרעה, אבל כשמתה צפורה לקח לו אחרת לשירות לא לתשמיש שהרי אף מצפורה פירש ואותה היתה מזרעו של חם כדכתיב ובני חם כוש וגו', עבד עבדים יהי', ולפי שהיתה מזרעו של חם דברו כך, תיט"ב:	NULL
Paaneach Raza, Beha'alotcha 44	הרק אך במשה דיבר, הרי תרי מיעוטין ואחריהם ריבוי הלא גם בנו וגו' מכאן שאין מיעוט אחר מיעוט אלא לרבות ומ"ש שאין ריבוי אחר ריבוי אלא למעט הוא מדכתיב גם לי גם לך לא יהי' גזורו, שאחר ב' גמי"ן הריבויין אמר לא יהי', למבין:	Numbers 12:2
Paaneach Raza, Beha'alotcha 45	ענו מאד, חסר יו"ד כתיב לדורשו ענו לשון עניה וצעקת קול כמו ויען, כלומר ענו ואמרו כולם שהוא עניו מאד, ד"א כדי שיהי' מספר סופי תיבות של ה' חומשי תורה העולים קכ"ו כמנין ענו חסר (והתכלית לומר שאף שידע התורה כולה עד סופה והיא נקראת תורת משה על שמו עם כ"ז התעניו מאד:	Numbers 12:3
Paaneach Raza, Beha'alotcha 48	ד"א ידוע שכל התגאות האדם יבא מצד דברים רוחניים והנפש שבו, כי איך יתגאה מחומרו וגוש עפר רימה ותולעה, והנה בשותפות הקב"ה ואב ואם יש חלק אלקי ממעל י' דברים רוחניים, ראית העין ושמיעת האוזן וכו', והוא בענותנותו התענוו מאד עד כאלו חסרו לו כל העשרה דברים הרוחניים, כאלו לא היו בו כ"א חומר עכור לבד לכן כתיב ענו חסר יו"ד):	Numbers 12:3
Paaneach Raza, Beha'alotcha 47	פתאום, פי' שלא יאמרו משה הי' קובל עליהם להקב"ה כי הוא לא רצה לתבוע עלבונו:	NULL
Paaneach Raza, Beha'alotcha 48	פה אל פה, לא כן בשאר נביאים דלא כתיב בהם וידבר ה' אל פלוני, אף שכתוב ויהי דבר ה' זהו ע"י מלאך ושליח. הר"ר אליעזר:	Numbers 12:8
Paaneach Raza, Beha'alotcha 49	בכל ביתי נאמן הוא, לא שנאמן מלגנוב דאטו כסף וזהב יש שם, אלא נאמן רוח מכסה דבר מלגלות לישראל דברים שלמעלה כיחזקאל וישעי' וכיוצא שהגידו לרבים כל מה שראו למעלה רק לאהרן הגיד בחשאי וסוד נעלם, ולישראל אמר דרך כלל והעלם ראיתי מה שאין האוזן ראוי' לשמוע, אלא תדעו כי ה' אלהינו הוא ה' אחד ואין בלתו, הר"ר יעקב:	NULL
Paaneach Raza, Beha'alotcha 50	אדבר בו פי' בקרבו כמו רוח ה' דבר בי, שרוח הקב"ה הוא בתוך האדם והוא המודיעו דברי הש"י ושייך בי' שפיר דבור:	NULL
Paaneach Raza, Beha'alotcha 51	אל נא תהי כמת פירש"י שאם אינך מרפא לה מי מסגירה וכו' עד וזהו אשר בצאתו מרחם אמו, פי' שכן יש בספרי, קטן שנולד מצורע מבטן אמו אין לו טהרה עולמית לפי שאין יכולים לקיים בו והסגיר והוי כמת, א"כ ה"נ כיון שאין אנו יכולים לקיים בה והסגיר הוי נמי כמוהו ואין לה רפואה, אבל מ"מ באמת הוי זה צרעת שי"ל רפואה בתשובה ותפלה שמועילין לו כיון שבא על החטא כמו באבימלך והקשה מהר"ר חיים שכיון שאין מי שיסגירנה הויא טהורה גמורה כדאמרינן בחולין טומאה וטהרה ביד כהן אם אין הכהן רוצה לטמא טהור, ותירץ דה"פ מאחר שהקב"ה אמר תסגר כבר צריכה עכ"פ לטהרה שהקב"ה כהן הוא כדאי' בסנהדרין ואמר הקב"ה כיון שאני טמאתיה אף אני מטהרה אחר ז' ימים, זהו ואחר תאסף, מרבי:	Numbers 12:13
Paaneach Raza, Beha'alotcha 52	ד"א אל נא תהי כמת, שלא תהי' כולד היוצא מחוסר אבר ובעל מום מרחם אמו והכל מבקשים עליו רחמים שימות:	Numbers 12:13
Paaneach Raza, Beha'alotcha 53	והעם לא נסע עד האסף מרים שלא נעלה הענן מפני כבודו של משה, ולפי המדרש שהי' הענן בזכות מרים הדבר פשוט שלא נסעו:	Numbers 12:15
Paaneach Raza, Beha'alotcha 54	לא נסע שהיא המתינה למשה על היאור שליש שעה לכן הוצרך ישראל להמתין לה ז' ימים שהם קס"ח שעות שעולים תק"ד שלישי שעה כי מדה טובה מרובה על אחת ת"ק, הר"ר אליעזר:	Numbers 12:15
Paaneach Raza, Sh'lach 1	@במדבר פרשת שלח	NULL
Paaneach Raza, Sh'lach 2	ובעזר הוריד עינו כעין הבדולח, נתחיל סדר שלח:	NULL
Paaneach Raza, Sh'lach 3	שלח" לך" אנשים" ס"ת חכ"ם לומר באותה שעה היו כולם חכמים וחשובים (ונרמז זה בס"ת הפך הסברא שכיון שמתחלה היו כן ראוי הרמז לבא בר"ת בתחלה, אלא מפני שרמז שלא היו כהחכם עיניו בראשו):	NULL
Paaneach Raza, Sh'lach 4	כל נשיא בהם, פי' לכל נשיא קח א' משבטו, זהו בהם, לא שישלח הנשיאים עצמן, שהרי לעיל זכר שמות הנשיאים בפ' במדבר, ולא הן השמות שזכר כאן, ועוד דאמר לקמן כולם אנשים ולא אמר כולם נשיאים (ואדרבא אנשים הוא הפוך וערבוב אותיות נשאים, וחסר, לומר כי היו חסרי ומהופכי נשיאות, ומה שתלה הדבר בנשיאים לומר עוד כל נשיא בהם ולא הספיק לו איש אחד איש אחד למטה לבד, היינו משום שילכו בכח נשיאיהם וכאלו היו צריכים הנשיאים להלך בעצמם וכבודם, רק שכ"א שולח את זה תחתיו ולעשות שלוחו של אדם כמותו כולי האי ואולי יעמדו בכשרותם בשומם זאת על לבם, או שיאמר שגם השלוחים האלה היו ראוים להיות נשיאים אז, זהו כל נשיא בהם, כלומר כ"א ראוי להיות נשיא, אבל בהם, כלומר שבאמת היו בהם ר"ל בכלל העם ולא היו באמת נשיאים נבדלים לעצמם):	Numbers 13:2-3
Paaneach Raza, Sh'lach 5	כולם אנשים, פי' רש"י לשון חשיבות כי באותה שעה כשרים היו, וקשה והא כתיב לקמן וילכו ויבאו ופירש"י מקיש הליכתן לביאתן וכו', וי"ל דמשה טעה בהם והי' סבור כי כשרים היו באותה שעה:	Numbers 13:3
Paaneach Raza, Sh'lach 6	למטה אפרים, תימה למה סדרו במקום זבולון, וי"ל שלא רצה שילכו בני רחל לעצמן כ"א כולם בחבור א' גם יחד:	Numbers 13:8
Paaneach Raza, Sh'lach 7	למטה יוסף למטה מנשה גדי וגו' וקשה דבכ"מ מייחס את אפרים על יוסף לומר למטה יוסף למטה אפרים וכאן על מנשה, וי"ל כי בכאן המשולח ממנשה תפס אומנת יוסף אביו והביא דבה משא"כ בהושע בן נון למטה אפרים:	Numbers 13:11
Paaneach Raza, Sh'lach 8	להושע בן נון יהושע פי' כבר מיד שנעשה משרת לו ומצא חן בעיניו שינה את שמו לעילוי כאשר עשה הש"י לאבות, וכן פרעה ליוסף ונבוכדנצר לדניאל וחבריו ולא שקרא כן עתה כדעת רש"י, ומה שלא שלח משה ג"כ איש א' ממטה לוי משום דלא הוטל עליהם לרגל את הארץ כיון שלא נטלו חלק בה, ג"ן:	Numbers 13:16-17
Paaneach Raza, Sh'lach 9	יהושע. פירש"י יה יושיעך וכו', וקשה מכיון שידע שיחטאו למה שלחן, וי"ל שהעם החזיקו עליו לשלוח כדכתיב במשנה תורה ותקרבון אלי כלכם וגו':	NULL
Paaneach Raza, Sh'lach 10	וישלח" אותם" משה" ס"ת חמ"ה לומר כי יכנסו בחמה לעיר (ורמז זה דוקא בס"ת להורות על משפט זה שיהי' בסוף דהיינו שיכנסו עכ"פ בכי טוב, דאע"פ שכמו כן ראוי לצאת בכי טוב מ"מ ביציאה אין משפט זה נוהג לעולם דביציאה ראשונה שמביתו א"צ, דבקרוב למקומו הוא בקי ורגיל וניכר לכל באופן שאין לו לירא שם לא מלסטים ולא מחיות רעות ולא מקוצים וברקנים ופחתים ולא מכלום, דזהו לדעת הענין שהקדימו בגמ' הכניסה לומר לעולם יכנס אדם בכי טוב ויצא בכי טוב, הזכירו הכניסה תחלה אשר הרגישו בזה התוס' שם וכמעט כל המפרשי'. אלא משום דבכניסה דוקא צריך אזהרה לכל כניסה וכניסה אפי' ראשונה שהרי היא עכ"פ בריחוק מהלך יום מביתו אשר כבר גם שם אינו בקי להזהר אבל ביציאה אין הזהר אלא בשל יום שני ומשם והלאה, הרי כי כניסה המחויבת להזהר קדמה ליציאה המחויבת, וגם שבזה הסדר סמך הכניסה למלת לעולם לומר לעולם יכנס וכו' לאפוקי ביציאה לא יאמר לעולם ומטעם הנזכר, והנה כ"ש שבמרגלים לא הי' שייך הזהר ומורא ביציאתם הראשונה לכן רמז אותיות חמה בס"ת להזהירם ביותר על סוף היום שהוא כניסה ראשונה וכן על יציאות שלבסוף כלומר שאחר כניסה זו לא על יציאתם מן המחנה מתחלה:	Numbers 13:17
Paaneach Raza, Sh'lach 11	עלו זה בנגב פי' בארץ נגובה ויבשה כמו כאפיקים בנגב, וסוף המקרא מכריח שאמר ועליתם את ההר, כלומר שאמר שאל ילכו דרך המלך לעלות במסילה פן יפגעום האויבים רק דרך מדבר הרים וגבעות ילכו:	Numbers 13:17
Paaneach Raza, Sh'lach 12	חמת" ויעלו" בנגב" ויבא" ס"ת אבו"ת למפרע לרמז שהלך להשתטח על קברי אבות (ונרמז בס"ת ולמפרע לרמוז שהולך להתפלל שאל יהא ניסת לעצת מרגלים להביא דבה לבסוף בשובם וחזרתם לאחוריהם ושיהא נהפך הוא הפך דעתם כאשר עשה כדכתיב ויהס כלב וגו'), ולפשוטו אמר ויבא בלשון יחיד אף שהיו רבים מפני שהיו אורבים והמארב נקרא תמיד לשון יחיד דכתיב האורב קם מהרה וירוצו וגו' וכן הרבה:	Numbers 13:17
Paaneach Raza, Sh'lach 13	שבע שנים נבנתה וגו', כלומר ואעפ"כ עדיין נמצאים בה בני ענק הראשונים ובא הכתוב להכחיש בזה את דברי המרגלים שאמרו ארץ אוכלת יושבי' הוא שאנשיה מתים בחצי ימיהם:	NULL
Paaneach Raza, Sh'lach 14	היש בה עץ אם אין, וכי יש לך ארץ או מלכות בלא עץ, אלא פי' אם יש בה עץ גדול לבנות דייק להלחם ואז יראים הם ואם לאו בוטחים על גבורתם:	NULL
Paaneach Raza, Sh'lach 15	והתחזקתם ולקחתם וגו', לא הזכיר להם שום חיזוק עד שעת לקיחת הפרי משום שאז יהיו כולם טעונים משא וצריכים חיזוק ביותר:	Numbers 13:20
Paaneach Raza, Sh'lach 16	זמורה ואשכול, פי' תרי מילין נינהו דהיינו זמורה עבה וגדולה לעשות ממנה מוטות דאי כפירש"י זמורה עם אשכול או זמורת אשכול מבע"ל או לשתוק מזמורה לגמרי, ועוד פירש"י ממשמע שנאמר במוט א"י ששנים נשאו בה, וקשה תיפוק לי' מוישאוהו לשון רבים דמשמע שנים לפחות דעכ"פ תפסת מועט תפסת, (וי"ל דוישאוהו הוה אפשר לפרש דלעולם בפ"א לא נשאו בו שנים כ"א אחד נשאו על כתפיו לאחוז בידו בקצה האחד וקצהו הב' תולה כנהוג במשא א', והא דקאמר וישאוהו היינו שהיו מחלפים בו זה בעד זה וכ"א נשאו זמן מה כי יכבד על א' לישאנו תמיד לכן דייק מדכתיב במוט שפירושו הפשוט בודאי ששנים ביחד נשאוהו כדין המוט), עוד פירש"י יהושע וכלב לא נטלו כלום וקשה דבתנחומא אמרו בפירוש שהמרגלים לא רצו ליטול עד ששלף כלב חרבו וכו' ולחצם ליטול ואיך א"כ לא נטל הוא עצמו וצ"ע, לוי:	Numbers 13:23
Paaneach Raza, Sh'lach 17	ונראה לי דמשה הכריחם ליטול, אמרו הם הרי אנו מוכרחים ליטול אבל תדע נאמנה שאנחנו נאמר בו לגנאי ולדבת הארץ לומר כשם שפרי' וכו' ומאז לא רצו יהושע וכלב ליטול:	NULL
Paaneach Raza, Sh'lach 18	וישלח אותם משה ע"פ ה', וקשה הא אמר בתחלת הפרשה שלח לך ופירש"י בו לדעתך, אני איני מצוך, וי"ל דעצם השילוח באמת צוה הקב"ה ע"פ דבריהם שאמרו נשלחה אנשים לפנינו אבל מי ומי ההולכים, זה הניח ע"ד של משה שבירר הוא הכשרים בעיניו בשביל שהי' גלוי לפניו ית' שסופן לטעות (אבל קשה הרי כתב רש"י לעיל בפי' אם תרצה שלח דמשמע שעצם השליחות מסר לבחירתו גם כאן כתיב אותם משה ע"פ ה' דמשמע מה ששלח אותם בפרטות זה הי' ע"פ ה', לכן נ"ל באמת איפכא דעצם השליחות הניח ע"ד משה ועליו אמר שלח לך לדעתך אם תרצה לשמוע דבריהם אבל צוה לו שאם באולי ישלח יברור לפחות הכשרים בעיניו באולי לא יסעו, ולכן א"ל לעיל כל נשיא בהם תשלחו שאף שאין פי' שישלח הנשיאים עצמן כדלעיל, מ"מ אמר לו זה הלשון לשיברור הראוים להיות נשיאים וכדכתיבנא אני לעיל בדקדוק כל נשיא בהם, ולכן אמר ג"כ שלח לך אנשים ויתורו וגו', שאם תרצה לשלוח תראה לשלוח אנשים לשון חשיבות כפירש"י אח"כ. וזהו שכתב כאן אותם ע"פ ה' שאותם ראה משה לכשרים אשר ירצה בם הש"י):	NULL
Paaneach Raza, Sh'lach 19	עד נחל אשכול, זהו שאמר הכתוב אשכלות מרורות למו שבשביל שבזה האשכול חטאו י' מרגלים וימאסו בארץ חמדה שתו כוס תרעלה וגלו י' שבטים ממנה, ולכן נקט אשכלות לשון רבים לרמז שבשביל שחטאו בו עשרה שהם עדה וקהל עם רבים, וזהו מרורות למו, שנרמז בזה מרורות לעצמם שהוא בגימט' ונושנת"ם (ועוד אמר אשכלות לשון רבים כי שתים רעות גרמו בזה, א' שלקו הם על כך במדבר, ב' שגלו בשביל כך מן הארץ, וכ"ז הוא הענין והוא הדבר אצלי בטעם אשכל חסר כי נמסר במסורה ה' חסרים דהיינו בפ' לך לך ב' פעמים בשם האיש אשכל ריע ענר וממרא בעלי ברית אברם וכאן ויבאו עד נחל אשכל, וכן שנית בענין הזה בפ' דברים ויפנו ויעלו ההרה ויבאו עד נחל אשכל וירגלו אותה, וחמישי בשיר השירים אשכל הכפר דודי לי, והטעם כי יש במדרש תנחומא שפירוש נחל אשכל הוא כך נחל של אשכל בעל ברית שגלוי הי' לפניו ית' שעתידין מרגלים לכרות אשכל ענבים בגבולו לכן קרא שמו אשכול ע"כ, והנה הכריתה ההוא כפולה לגריעותא וחסרון דהיינו שחטאו בזה להוציא דבה ולקו על כך, ועוד גרמו בזה גלות עשרת השבטים כנזכר לכן שם האיש הנקרא כן ע"ש המעשה הזה בא ב"פ חסר לבחינת ב' חסרונות ותקלות שהי' כאן וכן פשוט בעצם זכרון המעשה ב"פ ראוי לבא חסר על כך ולהורות כי גם את זה לעומת זה עשה אלהים שסבב שם האיש כן על שם מעשה זה כנזכר מהמדרש וזהו בעצמו טעם נכון לשנשנה המעשה הזה במשנה תורה כדי לחסרו שנית ולרמז על ב' החסרונות והרעות שגרמו בזה, ועם כ"ז הוא ית' ברחמיו ורוב חסדיו מכפר ועל כל פשעים תכסה אהבתו אלינו לכן בא אשכל הכפר ג"כ חסר לומר שעם כל חסרונות אלה הוא הוא המכפר פעמים פעמים וכפירש"י שם על אשכל הכפר, והדברים נכונים):	Numbers 13:24
Paaneach Raza, Sh'lach 20	מקץ מ' יום פירש"י מלמד שקפצה להם הארץ, וקשה א"כ ליחשבי' בהדי הנך שקפצה להם כאליעזר ואבישי, וי"ל דרשעים לא קחשיב:	Numbers 13:25-26
Paaneach Raza, Sh'lach 21	ילדי הענק, כתיב חסר יו"ד באמצע שיהי' כלשון נקבה, ילדה, מפני שאמרו המרגלים בת אחת ילדה היתה לו והגביהתה הקליפה עמנו והשליכתנו חוץ לפרדס, מצאתי:	NULL
Paaneach Raza, Sh'lach 22	ארץ אוכלת יושביה היא, פי' מכח רוב הרים וגבעות משתבריח העם מטורח עלי' וירידה כדאיתא בעירובין עיר שיש בה מעלות ומורדות אנשיה מזקינים בחצי ימיהם:	NULL
Paaneach Raza, Sh'lach 23	ויהס כלב, וקשה למה הי' שותק יהושע וי"ל דודאי פתח הוא ודבר טוב על הארץ, אבל המרגלים גערו בו ושיתקוהו לומר לית קטינא ימלל, פי' מכח שא"ל בנים ידבר ולא יפחד מלעלות, אבל אנו דואגים מנשינו וטפינו, טו"ב:	Numbers 13:30
Paaneach Raza, Sh'lach 24	עלה נעלה כתיב עלה בה"י כאלו הי' לשון יחיד לומר שאפי' יחיד שהי' עולה יוכל להם ברצונו ית' כ"ש כשנעלה כולנו ד"א לרמז שאף אם יאמר לנו עשו סולמות ועלו לרקיע מהלך ת"ק שנה, נעלה, וזהו רמז הה"י:	Numbers 13:30
Paaneach Raza, Sh'lach 25	ויפול משה ואהרן על פניהם, וקשה ויפלו מבע"ל כבפרשת קרח בענין תפלת אל אלהי הרוחות וגו', וי"ל דכאן נפלו לפני קהל עדת ישראל כדכתיב והוצרך משה לעמוד מיד מפני שנדבר עמו הש"י:	Numbers 14:5
Paaneach Raza, Sh'lach 26	כי לחמנו הם שאף אם לא נגרשם מהר יהיו לנו למס עובד ויתנו לנו ממון הרבה, ד"א בעת הלחמם בנו לא יהי' להם תקומה לפנינו, ר' ברכי':	Numbers 14:9
Paaneach Raza, Sh'lach 27	סר צלם הוא הקב"ה שהוא צל עולם כדכתיב ה' צלי, ד"א בשם ר' אלי' שמצא כתוב מלמד שלא ראו צל צואריהם ביום הושענה רבה:	Numbers 14:9
Paaneach Raza, Sh'lach 28	עד אנה ינאצוני המרגלים, ועד אנה לא יאמינו לי שאר ישראל:	Numbers 14:11
Paaneach Raza, Sh'lach 29	והמתי את העם הזה כאיש א' פי' בפעם א' לפחות הרגם לאט לאט בכדי שיפרו וירבו ביני ביני וזהו סלחתי כדבריך שאעשה כן:	Numbers 14:15
Paaneach Raza, Sh'lach 30	ועתה יגדל נא היו"ד רבתי בעבור כי בתפלה זו לא זכר זכות אבות כבפ' ויחל מפני שהם היו תאבים וחפצים בארץ ואלו הוציאו דבה לכן חזר לפחות ורמז ביו"ד לאברהם שעמד ביו"ד נסיונות וליצחק שנתן רב מעשר כאמרם על מאה שערים אומד זה למעשר הי', וליעקב שנתברך בעשר ברכות ויתן לך, זהו יו"ד רבתי, כי גדולים הם מעשי העשיריות האלה לכן תפנה אל זכותם:	Numbers 14:17
Paaneach Raza, Sh'lach 32	(ד"א כי היו"ד הוא אות וסימן לשמו ית' מכמה פעמים אשר לא נאריך בהם שלכן הושמה ראשונה בשם הנכבד, והנה רמז לו באמרו יגדל ביו"ד רבתי, כלומר יו"ד גד"ל, שכביכול הוא ית' מתגדל ומקבל כח מהם בהתקיימם שמוסיפים כח למעלה כשעושים רצונו כנודע, וכן להפך ח"ו כביכול מתישין כחו שלכן יו"ד של צור ילדך תש"י היא זעירא כאלו אמר ת"ש יו"ד וק"ל):	Numbers 14:17
Paaneach Raza, Sh'lach 32	ארך אפים, חיסר משה כאן אל שהוא לשון חוזק והם אמרו כי חזק הוא ממנו וכיונו כלפי מעלה וכן לא הזכיר רחום וחנון מפני שדרשו בו רחום קודם שיחטא וכו', והרי כבר חטאו בעגל ולא מחל כדכתיב ופקדתי ועוד דכתיב כי לא עם בינות הוא ע"כ לא ירחמנו עושהו ויוצרו לא יחננו, ולא הזכיר ואמת דלא לישתמע שיאמת הש"י דבריו מה שאמר אכנו בדבר וגו', ועוד שהם שקרו בדבתם, וחסד נמי לא הזכיר בעבור שהוא מדת אברהם וגם הוא חטא בירושת הארץ במאמר במה אדע, וחטאה לא הזכיר שמשמעותו שוגג והם הזידו:	Numbers 14:18
Paaneach Raza, Sh'lach 33	אם יראו, פי' בחייהם דומיא דכי כל האנשים הרואים את כבודי דמיירי בהוה בחייהם אבל במיתתם יראוה דמיירי הכא בשאר העם:	NULL
Paaneach Raza, Sh'lach 34	וכל מנאצי לא יראוה, אלו המרגלים ופי' לא יראוה לעולם, דאל"כ מהו ההפרש והכפל הזה:	NULL
Paaneach Raza, Sh'lach 35	ועבדי כלב וגו', וא"ת למה לא שיבח גם ליהושע כמוהו וי"ל דתפלה יה יושיעך עמדה לו ואין חידוש שניצול מעצת מרגלים, משא"כ בכלב שמעצמו נתאמץ, ד"א דכל עיקר הכונה הוא למאמר וזרעו יורישנה דאינו שייך ביהושע שלא הי"ל זרע כדכתיב נון בנו יהושע בנו ותו ליכא:	Numbers 14:24
Paaneach Raza, Sh'lach 36	רוח אחרת וגו', פירש"י א' בפה וכו', וקשה אם בא להחניף להם איך נמלט מלישא עמהם, וי"ל שעשה עצמו חולה אבל יהושע לא הי' צריך לכ"ז כי בטח לבו בתפלת יה יושיעך לכן לא החניף להם (אולי זהו בעצמו פי' היתה רוח אחרת עמו דנקט נפשו בקצירא והלביש רוח נשברה חלושה וקצרה):	Numbers 14:24
Paaneach Raza, Sh'lach 37	עד מתי לעדה פירש"י מכאן לעדה שהיא עשרה וכן עדה במילואו בגימט' עש"ר כזה עי"ן דל"ת ה"א וכן א"ב ג"ד בגימ' עשרה ואח"כ באו ה"ו שהוא שמו של הקב"ה, כי בעדה עשרה ישכון שמו וזהו בכ"מ אשר אזכיר את שמי אבוא אליך וברכתיך, ולכן אבוא מלא בוי"ו שעולה ג"כ עשרה:	Numbers 14:27
Paaneach Raza, Sh'lach 38	ופגריכם אתם יפלו במדבר, אזהרה שלא יעלו בניהם עצמותיהם לארץ לקברם. דאל"כ למה זה לי הלא כבר כתיב במדבר הזה יפלו פגריכם (וקשה לי הלא גם זה כבר אמור בו כל מנאצי לא יראוה כדלעיל, לכן נ"ל שהכפל הזה בא לעורר שילכו בעצמם בחייהם לשכוב תוך החפירות בכל שנה ושנה וכדאיתא בתלמוד ובמדרש שזהו עצמו תיקון ודקדוק לשון ופגריכם אתם, שאתם בעודכם בעצמכם תיעשו כפגרים ולכן בא כאן יפלו באחרונה אחר ופגריכם, היפך מבסמוך שאמר במדבר הזה יפלו פגריכם, יפלו תחלה, אלא שבכאן רמז על שאחר שתשכבו שמה בהיותכם אתם כלומר בחיים חייתכם ובבריאות שם תשארו נופלים שדוד):	Numbers 14:32
Paaneach Raza, Sh'lach 39	זנותיכם. זה עון העגל עונותיכם זה עון מרגלים:	NULL
Paaneach Raza, Sh'lach 40	במגפה לפני ה' שאף כשהי' במדת רחמים ע"י תפלת משה הי' דן למרגלים בדין ומדת סאה בסאה:	Numbers 14:37-38
Paaneach Raza, Sh'lach 41	תרימו תרומה תימה למה לא מחייבינן להפריש ב' תרומות כמו בחלה, חלת האור וחלת כהן, וי"ל דמכיון שמפריש תרומה מיד מחייב במעשר ואם הי' תורם שנית הי' המעשר מקולקל שמפקיעו וממעט בו, כדאמרינן המרבה במעשרות פירותיו מתוקנין ומעשרותיו מקולקלין שמפקיע ממעשר שני:	Numbers 15:19-20
Paaneach Raza, Sh'lach 42	כתרומת גורן וגו' שכמו שאם אכל בלי שיפרישנה חייב מיתה כך אם אכל משעת גלגול העיסה בלי הפרשת חלה:	Numbers 15:20
Paaneach Raza, Sh'lach 43	ואם נפש אחת תחטא לעולם תולה הכתוב החטא בנפש שהוא ממקום קדושה וטהרה ונעשה בו רושם ע"י החטא משא"כ בגוף שחוזר למקומו מקום עפר רימה ותולעה:	Numbers 15:27
Paaneach Raza, Sh'lach 44	ויהיו ב"י במדבר וימצאו וגו' פירש"י בגנותן של ישראל דיבר הכתוב שלא שמרו אלא שבת א' וכו' פי' דל"ל למיכתב ויהיו ב"י במדבר דאטו עד היום לא ידענא אלא לומר שמיד בהיותם במדבר בא זה וחילל שבת, ג"ן:	Numbers 15:32
Paaneach Raza, Sh'lach 45	כי לא פורש וגו' וקשה וכי לא ידעו מחלליה מות יומת וכל מיתה סתם שבתורה הוא חנק, ועוד למה נתחייב באמת בסקילה, וי"ל דילפינן חילל חילל מע"ז והם היו מסופקים אי ילפינן אם לאו וקשה לר' יהודא דאמר בכל התראה צריך שיודיעוהו באיזה מיתה יהא נידון א"כ היאך נתחייב כאן מיתה, וי"ל שהתרו בו מכל ד' מיתות והתיר עצמו למיתה בכולן, גן:	Numbers 15:34
Paaneach Raza, Sh'lach 46	ועשו להם ציצית נסמכו פ' ע"ז ושבת דהיינו מקושש ופ' ציצית לומר ששבת וכן ציצית שקולים נגד כל המצות, ונסמכה גם פ' ציצית לעושה בשגגה משום דכתיב בה וראיתם וזכרתם שמתוכה יזכור ולא ישגה כאדם שעושה לו קשר לזכרון, ד"א נסמכה פ' ציצית לשבת שמשום שאין מצות תפילין בשבת שמא ישכחו לשבות אמר הקב"ה הריני נותן להם אחרת תחת זה המזכרת את האדם הנוהגת בשבת כבחול דהיינו ציצית, זהו וזכרתם וגו', מרבי:	Numbers 15:38
Paaneach Raza, Korach 1	@במדבר פרשת קרח	NULL
Paaneach Raza, Korach 2	ובעזר צוה מטה אהרן והנה פרח, נתחיל סדר ויקח קרח:	NULL
Paaneach Raza, Korach 3	ויקח קרח, נסמכה לפ' ציצית שעיקר המחלוקת בא מהציצית כדאיתא במדרש טלית שכולה תכלת וכו' (וזה עצמו ויקח שלקח מה שנזכר לפניו בסמוך שהלבישן טליתות של תכלת), ומה ראה לחלוק, אמר שמי קר"ח בגימט' אלעז"ר ובאתי מיצהר שכולו זית לכן ראוי גם לי הכהונה כמוהו, וכן המלכות שהמלכים נמשחים בשמן, ולכך נאמר בן יצהר:	Numbers 16:1
Paaneach Raza, Korach 4	ודתן ואבירם וגו', תימה דבשלמא קרח ערער על שהוא לוי אבל אלו למה ערערו עליה, וי"ל שאמרו אנחנו מראובן הבכור והעבודה בבכורות ושמא תאמר שחטאנו בעגל הלא גם אהרן חטא בו:	Numbers 16:1
Paaneach Raza, Korach 5	נשיאי עדה, כלומר שרי אלפים ומאות ושרי חמשים ועשרות, ופחות מעשרה אין עדה ולכך קראי מועד חסר יו"ד שכ"א מהם נקרא לפחות על עשרה:	Numbers 16:2
Paaneach Raza, Korach 6	רב לכם, פי' למה תהי' כל השלטון והרבנות לכם, אני אהי' רב לכם ועליכם, ד"א הרבנות ושררה שאתם נוטלים הכל לכם להנאתכם, לכם" כי" כל" העדה" ס"ת מיל"ה כלומר הלא כולנו נמולים ככם:	NULL
Paaneach Raza, Korach 7	ויודע ה' את אשר לו אשר נאמן לפניו, ואת הקדוש לכהונה, שנאמר קדושים יהיו וגו':	NULL
Paaneach Raza, Korach 8	ואת אשר יבחר בו, לשמש לפניו:	Numbers 16:5
Paaneach Raza, Korach 9	לעמוד לפני העדה, מכאן שהשיר על הדוכן הי' בעמידה:	Numbers 16:9
Paaneach Raza, Korach 10	ויקרב אותך, לשיר כדכתיב בדברי הימים:	Numbers 16:10
Paaneach Raza, Korach 11	גם כהונה, לרבות המלכות:	NULL
Paaneach Raza, Korach 12	כי תלונו עליו, בוי"ו כתיב כלומר וי וי שאתם חולקים על רבכם ועוד שעל ו' אתם חולקים, משה, אהרן, אלעזר, איתמר, נחשון ואליצפן:	Numbers 16:11
Paaneach Raza, Korach 13	גם השתרר, למנות גם אחרים להשתרר עלינו, ד"א תשתרר במצרים באמור רשע למה תכה גם השתרר עתה במדבר, טו"ב:	NULL
Paaneach Raza, Korach 14	תשתרר, אין לך בכל המקרא תיבה רבת המספר כזו שעולה ט"ו מאות, וכן כל אותיות האלפ"א בית"א עולים ט"ו מאות פחות ה', שים תחתם ה' אותיות כפולות. דהיינו מנצפ"ך למלאות המספר, וכך אמר וכי תשתרר עלינו ששמעת התורה הכתובה באלפ"א בית"א מפי הגבורה גם אנו שמענו:	NULL
Paaneach Raza, Korach 15	אף לא אל ארץ זבת וגו' כלומר כנבואת אלדד ומידד שלא תביאנו אתה לארץ, ומה לחוש לציוויך:	Numbers 16:14
Paaneach Raza, Korach 16	ותתן לנו וגו' כלומר אף אם תכניסנו אתה לארץ לא תחלוק אותה לנו, כי היו מסופקים בנבואת אלדד ומידד אם לכיבוש אם לחלוקה:	Numbers 16:14
Paaneach Raza, Korach 17	העיני האנשים ההם תנקר כלומר אף עור בצהרים ימשש ויבין שאין בך ובציוויך ממש לכן לא נעלה, ד"א וכי רוצה אתה לסמות את עינינו שאין אנו מבינין טעותך ובדויי לבך, ד"א אף אם תנקר עיני הכנעניים לא נוכל לעלות עליהם לגודל ורוב חזקם וגבורתם:	Numbers 16:14
Paaneach Raza, Korach 18	ויחר למשה מאד מפני כי דבר משה אל קרח בפרטות כדכתיב ויאמר משה אל קרח שמעו נא וגו' והוא לא השיב לו מאומה ואין לך צער כזה שאינו משיב למוכיחו:	Numbers 16:15
Paaneach Raza, Korach 19	אל תפן אל מנחתם, לא שחשש משה ח"ו שהקב"ה יקבל מנחת שוא, אלא שלא ישרף חלקם שבתמיד של צבור ולא יהא לו ריח ניחוח:	Numbers 16:22
Paaneach Raza, Korach 20	לא חמור א' מהם נשאתי פי' ואיך תאמרו שאני לקחתי מלכות לעצמי הלא לא נהגתי עמכם כמשפט המלך אף בדבר א' מכל המבואר בס' שמואל:	NULL
Paaneach Raza, Korach 21	אתה והם ואהרן, וקשה הלא כבר אמר אתה וכל עדתך וגו' וי"ל דלכן כפל הדבר ללמוד מזה תשובת קרח שעל שאמר לו אתה וכל עדתך היו לפני ה' מיהר קרח ונכנס לתוך דבריו והשיב מה לי ולך הלא לא עליך אני מערער כ"א על אהרן, יעמוד בעל ריבי לנגדי ולא אתה, אז אמר משה אמנם כדבריך אתה והם ואהרן מחר וגו', ר' רחבי"ה:	NULL
Paaneach Raza, Korach 22	(ד"א שרמז לו שלא בטובתם יהיו לפני ה', זהו אתה והם כלומר אתה והם תלכו למיתה ולאיבוד, ואהרן מחר, כלומר והוא ילך לחיים טובים ויהא קיים למחר ולמחרתו, ולכן נקטינהו תחלה קודם לאהרן, לרמוז שהם יכלו ואהרן יהא קיים אחריהם, ולכך נגינת הטעם חולק והם מואהרן, לומר שאתה והם תהיו לצד א' ולבחינה אחת, ואהרן לעצמו לצד א' והטעם שתחת והם החולקו הוא טעם תביר ואתה נמשכת עמו, לרמוז כאומר אתה והם תלכו לשברון כי לפני שבר גאון, ועוד כפל אותם לרמז אם למ"ד קרח מן השרופים ומן הבלועים הי', לומר אתה והם, כלומר שברונך ישוה לכולם, ואם למ"ד לא מן השרופים ולא מן הבלועים הי' כפלו לחלק, אתה והם לסוגים מחולקים, או שכפלו לרמוז והם על השרופים או על הבלועים לבד לאיזה כת שאירע לו כהם, שעליהם יאמר אתה והם כלומר אתה תהי' כמותם):	NULL
Paaneach Raza, Korach 23	חמשים ומאתים מחתות, דכאן משמע שדתן ואבירם לא היו מהשרופים רק מן הבלועים לבד שהרי הם לא הקטירו והמקטירי' נשרפו וא"כ לא נענשו הם אלא מפני שדברו דופי במשה לחשדו באשת איש, שנאמר וישמע משה ויפול על פניו, שמועה זו שמע ולכך נענשו להם אפילו יונקי שדים:	NULL
Paaneach Raza, Korach 24	הבדלו, שהיו מעורבבים:	NULL
Paaneach Raza, Korach 25	הרומו, התרחקו יותר:	NULL
Paaneach Raza, Korach 26	אם בריאה יברא ה', לשון נקיבת נקב, כמו וברא אתהן בחרבותם דיחזקאל:	Numbers 16:30
Paaneach Raza, Korach 27	"כי "נאצו "האנשים "האלה, ר"ת כהנ"ה ור"ת הכה"ן, דמה שבקשו הכהונה הראוי' לכהן מיוחד וגדול מאחיו, (ובא הרמז בר"ת דוקא ובערבוב אותיות על שבקשו כהונה גדולה הראשיית המיוחדת לכהן אחד ולערבבה לערבוב הרבה אנשים שיהיו כולם כהנים גדולים):	Numbers 16:30
Paaneach Raza, Korach 28	האדם" אשר" לקרח", ס"ת חר"ם למפרע מלמד שגזר משה חרם על שיבדלו מהם (ולכך בא הרמז בס"ת ולמפרע לומר כי בתוכם היו גם שאר ב"א אשר ספו ותמו בבליעה על שהפכו בחרם ועברו עליו ולא קיימוהו כהלכתו וכסדרו):	NULL
Paaneach Raza, Korach 29	קר"ח אותיות חר"ק שהגיהנם חרק עליו שיניו ושאול פערה פיה:	NULL
Paaneach Raza, Korach 30	ואת האש זרה הלאה כי קדשו פי' שאין לכבות הגחלים שעל המזבח וכן במחתה ומנורה, ותימה למה אצטריך למילף מיתת נדב ואביהוא מעדת קרח שהגוף קיים פשיטא דא"כ לא נטמאו נושאיהם הא אין אפר מטמא אלא מדרבנן, וי"ל דיש עצם ששמו לוז שאינו נשרף והוא בשדרו של אדם וממנו חוזר ונברא לעתיד, והוא ענין אמרם בשדרו של אדם לאחר ז' שנים נעשה נחש:	Numbers 16:31
Paaneach Raza, Korach 31	נסו לקולם, לקלם כתיב חסר ו' לדרשו לשון שריפת אש כמו אשר קלם מלך בבל שהיו רואין עשן הגיהנם יוצא ושרפם וברחו:	Numbers 16:34
Paaneach Raza, Korach 32	כאשר דבר ה' ביד משה לו, אלעיל קאי אמאי דכתיב אמור אל אלעזר וגו' ויקח אלעזר וגו', גן:	Numbers 17:5
Paaneach Raza, Korach 33	אתם המתם את עם ה', שאמרתם להם להביא קטורת וידעתם שמתו בו נדב ואביהוא:	Numbers 17:6
Paaneach Raza, Korach 34	ויעמוד בין המתים וגו', פירש"י שאמר מה"מ אני שלוחו של מקום וכו', הרי משמע שהי' יכול לשחת ולנגוף אעפ"כ לולא שאחזו אהרן והעמידו ע"כ וא"כ מאי נפקותא במה שלמד מה"מ למשה סוד הקטורת. וי"ל דה"מ דמועיל שלא יתחיל אבל משהתחיל לא (ויש לזה כמה סתירות שאין להאריך בם אבל הענין הוא שכונת רש"י הוא שעכ"פ עצר אהרן בקטורת, רק שמפרש את מה שכתיב ויעמוד וגו' שהי' ויכוח זה בין אהרן והמלאך שהמלאך הפציר שלא יקטיר אהרן את הקטורת כלל בטענת אני שלוחו של מקום ואתה וכו' וסוף הדבר הי' שהי' רצון השי"ת להקטיר ולעצור וכענין הד"א ברש"י):	Numbers 17:13
Paaneach Raza, Korach 35	מטהו יפרח, בגימ' משי"ח שבימיו תחזור הכהונה ויפרח מטה אהרן:	Numbers 17:20
Paaneach Raza, Korach 36	ואת שם אהרן תכתוב על מטה לוי תימה עדיין הי' מקום לבני לוי להתרעם דשמא אם הי' כותב שם לוי כמו כן יפרח וא"כ לכ"א משבט לוי תיאות הכהונה, ועוד למה לא צוה ה' לעשות דבר המטות קודם מעשה קרח ולא היו באים לידי מדה זו, גמגום, מצאתי:	NULL
Paaneach Raza, Korach 37	(וי"ל דודאי ענין המטות לא הי' מופת על אהרן בפרטות כדאקשינן, ולכך לא ציוהו קודם מעשה קרח, דלא הי' מקום לשכך חמת קרח בכך, כיון שגם הוא הי' מלוי, רק שהי' זה למופת על השבט שלא יערערו שבטים אחרים כאשר עשו כבר הראובנים וזולתם, אבל משבט לוי בעצמו לא הי' צריך מופת לאהרן בפרטות בפרט אחר שנענש קרח שהי' ג"כ משבט לוי, ועוד מסתבר הוא שהרי על כך נקרא מטה לוי ע"ש אהרן, כדכתיב ומטה אהרן בתוך מטותם, כי מאחר שנתייחד כבר מטה למשה לעצמו שהוא מטה האלהים, פשיטא אם יבא עוד ענין מטות לשבטים שייך מטה לאהרן ביחוד, שהרי גם הוא הי' עם משה בשליחות מצרים ועשה אותו לעיני פרעה ולעיניהם, וזהו והשכותי את תלונות ב"י, לא תלונות בני לוי דזה כבר נשכך וזהו שאמר אשר הם מלינים עליכם ולא אמר על אהרן, אלא כלומר על השבט בכלל, דאלו לענין השבט בעצמו בינו לבינו ודאי אהרן הוא המובחר, אבל דלמא שבט לוי בכללו אינו נבחר, ע"ז נתן עתה מופת המטות ולכן אמר בסמוך והנה פרח מטה אהרן לבית לוי, לבית לוי ל"ל, אלא לומר שלא נתבקש המופת אלא לבית לוי, ואל יטעה אותך מה שאמר והי' האיש אשר אבחר בו וגו' דמשמע שהמופת על האיש הפרטי דעל אישים הנכתבים במטות קאמר, ככתוב איש את שמו תכתוב על מטהו, ובודאי גם כל השבטים האחרים לא הי' הכהונה על הנכתב בעצמו בפרטי דגם שם יקשה כנזכר דלמא שם איש אחר יהא נכתב ואין לדבר סוף א"ו כדאמרן):	NULL
Paaneach Raza, Korach 38	הן גוענו וכו', פי' אלו שמתו בשריפת אש ה' שנקרא גויעה, ומה שמתרגם הא מיננא קטלת חרבא, חרבו של מקום קאמר, שהוא האש:	Numbers 17:27
Paaneach Raza, Korach 39	וישרתוך בשיר על הקרבן:	NULL
Paaneach Raza, Korach 40	גם הם גם אתם, שהכהנים מוזהרים על עבודת הלוים ונענשים עליה כמו שהלוים נענשים על עבודת כהנים:	NULL
Paaneach Raza, Korach 41	ועבדתם עבודת מתנה, מה מתנה אחת לא' מהרבים בפייס אף עבודה בפייס כי משה תקן משמרות ופייסות:	Numbers 18:7
Paaneach Raza, Korach 42	לך נתתים למשחה, פירש"י לגדולה כלומר מכאן שהמתנות אינן נאכלין אלא צלי אש ובחרדל כדרך שהמלכים אוכלים:	Numbers 18:8
Paaneach Raza, Korach 43	ועבד הלוי וגו', הרי כבר נאמר חלף עבודתם אשר הם עובדים וגו', אלא לומר אף בשמיטין ויובלות שאין מעשרות נוהגים בהם (ומכאן שגם בזמן שאין בהמ"ק קיים ישרת הלוי לכהנים):	Numbers 18:23
Paaneach Raza, Chukat 1	@במדבר פרשת חקת	NULL
Paaneach Raza, Chukat 2	ובעזר מי יתן מטומאה טהרה, נתחיל סדר זאת חקת התורה:	NULL
Paaneach Raza, Chukat 3	זאת חקת התורה וסמיך ליה לעיל לא תחללו ולא תמותו לומר הא אם תחללו התורה תמותו, ד"א דכל בעל תורה העובר איזה עבירה הוי חילול השם, (ד"א לא תחללו ולא תמותו וסמיך לי' זאת חקת וגו' דבר אל ב"י וגו' לומר כי אם שמצות פרה הוא חקה שחקק הוא ית' וגזירה הוא מלפניו נעו מעגלותי' לא תדע ועמוקה משאול מה תדע, מ"מ אין זה חילול מאתכם ולא תמותו בו במה שאתם מדברים בה לב"י לדרוש בה טעמים ודברים דומים ומקובלים על הדעת קרובים אל השכל, וכאשר נהגו באמת כל המדרשים והפייט בעצמם שכל עוד שהפריזו מאד בהמנע ידיעתם והשגתה לעמוד על תכליתה, בו בפרק ובו במקום, הוציאו תיכף כמה מלין תילי תילין לצד עילאה ימללו ליתן בכל ענינים טוב טעם ודעת, משום דרוש וקבל שכר, ובפסיקתא איתא הכי, לכן נאמר זאת חקת התורה, חקה חקק הקב"ה ואין אתה יכול להרהר וכו', אלא מדרשות תוכל לדרוש בה כפי שהדעת סבולה עכ"ל, ואולי זה להם מסמיכות הזה כנז' או ביותר הניאות ממה דכתיב לאמר מיותר דכתיב שנית אשר צוה ה' לאמר, אלא לרמוז שהרשות נתונה לאמר בה טעמים ודרשים, ולכן האי לאמר בא בטעם אתנחתא לומר שמותר לומר בה מה שהדעת נוחה בה ומה שינוח בדעתו שהדעת סובלתו ומקבלתו):	Numbers 19:2
Paaneach Raza, Chukat 4	ויקחו אליך כי עתה אחר שנטמאו במתים הוצרכו לטהרה:	Numbers 19:2
Paaneach Raza, Chukat 5	פר"ה אדמ"ה בגימט' הי"א רחוק"ה כמאמר שלמה ע"ה אמרתי אחכמה והיא רחוקה וגו' ובגימט' לכפר"ה:	Numbers 19:2
Paaneach Raza, Chukat 6	אשר לא עלה עליה ע"ל, חסר ו' כתיב. על ו' דברים שפוסלין בה ומחסרין אותה מכשרותה דהיינו הניח עליה אפי' עור של סכין, עלה עליה זכר, דש בה, ומום, וב' שערות לבנות או שחורות, (ול"נ דחסר כתיב כדי שיוכל לקרותו על, לומר דלאו דוקא עול פוסל בה אלא כל שעל גבה לרצון בעלים):	Numbers 19:2
Paaneach Raza, Chukat 7	מים חיים אל כל"י, ר"ת "כהנים "לוים "ישראלים לומר שהתורה הנמשלת למים והיא חיים היא היא עיקר הטהרה לכל חלקי ישראל, מהר"ר אהרן:	Numbers 19:17-18
Paaneach Raza, Chukat 8	ותמת שם מרים וגו' ולא הי' מים וגו', מכאן רמז לשפך המים שבבתים כשיש מת בעיר (ותמ"ת ש"ם מרי"ם בגימט' בכא"ן רמ"ז לשפו"ך המי"ם מפנ"י המ"ת) ועוד ראי' מדכתיב בשמואל ב' כי מות נמות וכמים הנגרים ארצה, ד"א מכאן שהבאר בזכות מרים שכשמתה מיד ולא הי' מים וגו':	Numbers 20:1
Paaneach Raza, Chukat 9	ש"ם בגימט' יאסו"ר בהנא"ה דהמת אסור בהנאה ונסמכה פ' מיתת מרים לפרה, לרמוז שגם מיתת צדיקים מכפרת ומטהרת כמו הפרה:	NULL
Paaneach Raza, Chukat 10	קח את המטה, רבינו בכור שור פי' להכות את הסלע דזהו עצמו המעשה של פ' בשלח והכית בצור וגו' אלא דהתם בא לסדר פרנסת ישראל יחד, מן, ושלו, ובאר, ואח"כ מפרש כ"א במקומו, והמופת דכתיב התם ויקרא שם המקום מסה ומריבה, והכא כתיב המה מי מריבה וגו', ובוזאת הברכה כתיב אשר נסיתו במסה תריבהו על מי מריבה, ומ"ש ודברתם אל הסלע פי' אל פני הסלע שיהא הדבר נגלה לעיני כולם שאתן להם מים בנס, ואמרו משה ואהרן שמעו נא המורים שכעסו עליהם למה תריבון עמנו, וכי אנו יכולין ליתן לכם מים שלא ע"י הקב"ה, וא"כ דרך תפלה ובקשה הי' לכם לשאול לא דרך תלונה ומריבה:	NULL
Paaneach Raza, Chukat 11	ויך את הסלע במטהו פעמים ויצאו וגו', הנה ישראל אמרו שבמקרה ובטבע הוא זה שכל הסלעים נובעים מים ואף משה הי' סבור שלא יצאו כי זה הי' סלע אחר כדאיתא ברש"י ועל שלא פי' משה ואהרן דבריהם ביותר שהוא נס ופעל הש"י, לכן הקפיד הקב"ה עליהם יען לא האמנתם וגו', ג"ן:	Numbers 20:11
Paaneach Raza, Chukat 12	וקשה איך נסתייע מלתא שבא לידו סלע אחר, אלא שהסלע הלך לו בין הסלעים להגדיל הנס כדי שיוציא להם משה מים מאיזה סלע שירצו ישראל, ובזה טעה משה ואמר שמעו וגו' המן הסלע הזה וגו' שישראל בקשו מסלע אחר ואמר להם משה המן הסלע וגו' כמתמי' הלא לא לדבר אל הסלע הזה ציוני הקב"ה וכי מן הסלע הזה שלא נצטויני לדבר אליו נוציא לכם מים ועי"כ לא נתאמת אצל ישראל הדבר לנס וקידוש השם כי אמרו משה הי' רועה במדבר ויודע ומכיר בסלעים המוציאים מים ולכך כעס הקב"ה, וזהו יען אשר לא האמנתם בי, אבל לכ"ז קשה על אשר מריתם את פי דלקמן דהרי לפ"ז לא החליפו דברי השי"ת, וי"מ שהכעס הי' על שאמרו נוציא לכם מים כמדברים בעד עצמם ותלו הגדולה בעצמם וכמו כי משחיתים אנחנו, פי' רי"ח, (וכן פי' אני כונת הפייטן בפיוט ר"ה באמרו על משה יען נוקש בעשר נחרת בו מיתות עשר וכו', ע"ש, שר"ל בשביל שנכשל ביו"ד, כי אמר נוציא בנו"ן המדברים בעדם והיל"ל יוציא ביו"ד בכינוי כלפי הש"י, לכן מדה כנגד מדה נכתב עליו מיתה יו"ד פעמים בתורה, וזהו שדקדק דהע"ה בלשונו להזהר מזה ואמר ביו"ד יתירא ההופכי הצור אגם מים ולא אמר ההופך, כי יו"ד הוא הוראה עליו ית' ורמז א"כ בזה שהוא ית' ההופך שהפכו והוציא ממנו מים, וזה ג"כ ו' יתירא של חלמיש למעינו מים, למעין מים מבע"ל, אלא שאמר הפיכת החלמיש למים היא מיוחסה אליו ית' ומעיינו שלו היא נקרא:	NULL
Paaneach Raza, Chukat 13	לא תעבור בי וגו', ואח"כ אמר לא תעבור סתם ולא אמר בי מפני כי מתחלה שאלו לעבור דרך עיירות וגם בדגלים ושררה כדרך המלכים וזה קשה לאומות כשבט ברזל בלבבם, לכן אמר לא תעבור בי שזה הי' לי כאלו תעבור בי תוך גופי ולבי ממש, ואח"כ שאלו לעבור לפחות ברגליהם ובמסילה לא דרך עיירות ומיאן גם בזה והשיב לא תעבור כלל. שמעתי ממהר"ר ברוך במוהר"ר אברהם:	Numbers 20:18
Paaneach Raza, Chukat 14	וישמע הכנעני וגו' דרך האתרים וגו', פירש"י התייר הגדול וכו', פי' ר"י חסיד שזהו אהרן שבזכותו הי' הענן המתייר אותם וכשמת אהרן נסתלק, מיד וישמע הכנעני הוא עמלק ובא להלחם עמהם כפירש"י בסמוך:	Numbers 21:1
Paaneach Raza, Chukat 15	אם נתון תתן את העם הזה בידי, ואח"כ כתיב סתם ויתן את הכנעני ולא כתיב בידם, מפני שהקב"ה עשה להם יותר מאשר שאלה נפשם, ששלח מריבה בין הכנעני והעמלקי והרגו מהם ובהם, ואח"כ באו ישראל על החללים וכבשו הכרכים, מצאתי:	Numbers 21:2
Paaneach Raza, Chukat 16	והביט אל נחש הנחושת וחי כדי להגדיל הנס שמהמכה עצמה מתקן רטי':	Numbers 21:9
Paaneach Raza, Chukat 17	בספר מלחמות ה' כמו דברי הימים שבאים בו סיפורי מלחמות:	Numbers 21:14
Paaneach Raza, Chukat 18	ונשקפה על פני הישימון פי' נראית ע"פ המדבר להתענג להם ולמקניהם לשתיה ולהתעדן ולהתקרר:	Numbers 21:20-21
Paaneach Raza, Chukat 19	עד אשר נעבור גבולך פי' בסבוב ולא דרך עיירות וכן כתיב וכאשר עשו לי בני עשו:	Numbers 21:22-23
Paaneach Raza, Chukat 20	כ"י ע"ז בגימט' ע"ד יב"א דו"ד שהוא הכניעם:	Numbers 21:24
Paaneach Raza, Chukat 21	כי עז גבול בני עמון פי' עזה היא נגד סיחון שלא יכול לכובשו אבל לא נגד השי"ת חלילה וידו לא תקצר ולא קצרה, מהר"ר יעקב:	NULL
Paaneach Raza, Chukat 22	עם כמוש, בספר שכל טוב יש שהוא אבן אחת במדבר מששת ימי בראשית בדמות אשה שחורה, והולכים אחריו לטעות וא' מני אלף אינו חוזר, זהו אבדת עם כמוש, ובימי סיחון לא טעו אחריו כי אם מואב:	NULL
Paaneach Raza, Chukat 23	ונירם אבד חשבון וגו', ניר לשון יורש כמו למען היות ניר לדוד עבדו, כלומר ניר שלהם אבד את הארץ מחשבון עד דיבון שלא יירשנה עוד:	Numbers 21:30
Paaneach Raza, Chukat 24	אל תירא אותו פירש"י שהי' משה ירא פן תעמוד לו זכות אברהם שהגיד לו כי נשבה אחיו, וקשה והא לרעה נתכוין שיהרג אברהם וישא הוא את שרה, וי"ל דמ"מ היתה הצלה על ידו כמו שאנו אומרים בזכות מ"ב קרבנות שהקריב בלק זכה ויצא ממנו רות אע"פ שלקלל את ישראל נתכוין אלא שמ"מ נתכוין להקריב להש"י:	Numbers 21:34
Paaneach Raza, Balak 1	@במדבר פרשת בלק	NULL
Paaneach Raza, Balak 2	ובעזר אלהי יעקב איש חלק, נתחיל סדר וירא בלק:	NULL
Paaneach Raza, Balak 3	ויגר מואב לשון אגרה בקיץ שנתקבצו לעיירות:	Numbers 22:3
Paaneach Raza, Balak 4	ילחכו הקהל את כל סביבותנו כלומר פשיטא שלא יעשו לנו מאומה להלחם בנו מציווי אל תצר את מואב, אלא שישחיתו את כל יבול הארץ ותבואות שדותינו שסביבות העיר ויאמרו ימותו ברעב מאליהם, מרבי:	Numbers 22:4
Paaneach Raza, Balak 5	כלחוך השור נקט שור שאין לו שינים למעלה כסוס וחמור לקוץ ולגזוז העשבים וכחו גדול ועוקר הכל עם השורש:	Numbers 22:4
Paaneach Raza, Balak 6	אל בלעם בן בעור נראה שהוא הוא בלע בן בעור מלך ראשון שמלך באדום הנזכר ס"פ וישלח, וזה דקאמר התם ושם עירו דנהבה פי' דין של הב"ה נתחכמה שע"פ עצת בלעם הי' זה, כי ג' היו באותו עצה ולכן גם עתה בא מואב ליטול עצה ממנו להחכים לישראל ומושיען, בלע"ם ב"ן בעו"ר פתור"ה בגימט' פת"ר חלמ"ת:	NULL
Paaneach Raza, Balak 7	הנה עם יצא כלומר כמספר הנ"ה יצא עם דהיינו ששים רבוא:	Numbers 22:5
Paaneach Raza, Balak 8	כי ידעתי את אשר תברך מבורך, כי הוא נתנבא על מואב שיפול ביד סיחון:	Numbers 22:6
Paaneach Raza, Balak 9	וקסמים בידם פי' שכר הקסמים והוא שאמר התרגום ירושלמי ואגרין חתומין בידיהון, כלומר צרור כסף השכר, וי"מ את התרגום מלשון אגרת, שספרי קסמים הביאו בידיהם, ג"ן:	Numbers 22:7
Paaneach Raza, Balak 10	ואגרשנו מן הארץ, פי' מן הארץ שלי שכבשה סיחון ממנו והם נטלוה מידו:	NULL
Paaneach Raza, Balak 11	ויען בלעם ויאמר אל עבדי בלק, ותימה הלא לראשונים כינה הכתוב שרי מואב ואלו היו שרים רבים ונכבדים מהם וקראם עבדי בלק, וי"ל דצריך לומר עבדי בלק הנאמנים לו אשר אליהם גילה סוד שוחד לפסוק לבלעם שלכן אמר להם בלעם אם יתן לי בלק וגו', ובאמת היו שרים רבים ונכבדים מהראשונים והיו נאמנים למלכם לעבדים, הר"ר אליעזר (ולא קשיא כלל דמה שקרא לראשונים שרים היינו נגד כלל העם ובערכם של שאר עמו כדכתיב וישבו שרי מואב ולא שרי בלק, וכן בהני אחרונים כתיב נמי בסמוך וילך עם שרי מואב דלגבי המון עם מואב שרים היו כולם באמת, ומה שקרא לאלו כאן עבדי היינו לערך המלך שהרי אמר עבדי בלק ולא אמר עבדי מואב, ואע"פ דאהני אחרונים גופייהו כתיב נמי לקמן וילך בלעם עם שרי בלק, היינו לפי ענינו דהתם מכיון שהשיגו מבוקש שליחותם שבלעם כבר הלך עמם והפיקו רצון מלככם קירבם בלק בשתי ידים ונהג בם מנהג שרים עד שראוי לקרותם שם שרי בלק, ולכן לא כתיב כן בתחלת לכת בלעם עמם רק שם כתיב וילך עם שרי מואב כנזכר לפי שאז עדיין לא הועילו בשליחותן שהרי ויחר אף אלהים כי הולך הוא וגו' אבל עתה שהסכימה דעת עליון שילך והלך הרי הגיעו והפיקו מאוויי מלכם ועשאם עטרה לראשו והחזיקם גם אצלו ובערכו לשרים, ומה שקרא לראשונים שרים לערך כלל העם וייחסם אל העם וכן לאלו האחרונים קודם מעשה האתון ולא ייחסם שם ג"כ אל בלעם ולקרותם עבדי בלק היינו משום דבראשונים שבא לומר וישבו שרי מואב עם בלעם כלומר שהוצרכו להתעכב שם קראן כך לומר שעם היותם באמת שרים נכבדים הוכרחו להכנע ולהתעכב עם בלעם כרצונו לרוב חשק הקללה שהיו חפצים להשיג, ואלו בלשון עבדי בלק הי' אפשר להבין שהיו עבדיו השפלים ובאחרונים נמי כתיב כן לרבותא דויחר אף אלהים כי הולך הוא שאף עם שרים ונכבדים לא הי"ל להתאוות לילך, ועוד לנו בכל אלה דברים נמרצים והמה בכתובים ועת לקצר, ולמעיין בפסוקים היטב יערב לחכו):	Numbers 22:18
Paaneach Raza, Balak 12	אם לקרא לך בזה טעה בלעם וסבר שע"י קרבן שיקריב בלק על כך יתרצה הש"י, כי לקרא לשון הנופל בזבח הוא ככתוב בשמואל כי זבח היום לעם וגו' אחרי כן יאכלו הקרואים וגו', ויתן לכם מקום בראש הקרואים:	Numbers 22:20
Paaneach Raza, Balak 13	כי הולך הוא, שאחר שא"ל הש"י כבר לא תלך עמהם לא הי"ל לשאול עוד באחרונים לאמר ואדעה מה יוסיף השם דבר עמי:	Numbers 22:29
Paaneach Raza, Balak 14	לו יש חרב וגו' וקשה למה לא קלל אותה וי"ל דאז לא הי' יכול עוד לקלל את ישראל כמו שמצינו גבי אלישע ששלח את גחזי עם מקלו להחיות את הנער והחיה בו את הכלב עשה המקל שליחותו ולא הי' יכול אח"כ להחיות גם את הנער, מרבי:	NULL
Paaneach Raza, Balak 15	ד"א שבלעם הי' יודע לכוין את שעת כעס של הקב"ה ולא היתה אז אותה שעה:	NULL
Paaneach Raza, Balak 16	כי ירט הדרך לנגדי לשון סגירה וסתימה מעיקושי הדרך כמו ועל ידי רשעים ירטני דאיוב:	NULL
Paaneach Raza, Balak 17	גם אותך הרגתי לפי הפשט א"צ בסירוס הכתוב כפירש"י דגם אותכה ר"ל כמו שני נעריך שאותם הרג המלאך שהרי מכאן והלאה לא נזכרו עוד, ג"ן:	NULL
Paaneach Raza, Balak 18	(ול"נ דהאי גם אתי לרבויי חמשת מלכי מדין אשר עמהם נהרג בלעם, כי הדבקות שבינו וביניהם וכח חיבורם למעלה הי' מכריח שאם הי' בלעם נהרג עתה בהכרח היו נהרגים גם הם עמו כמו שנתנה מדה זו שהוא נהרג עמם באמת, והוא הוא רמז מאמר על חלליהם שבהכרח נהרג הוא עליהם ועמם כשנעשו הם חללים, ועוד יש בעל חלליהם רמז עמוק לזה למבין, מלבד שהדברים פשוטים, בשגם ע"פ עצת זקני מדין הי' זה לישראל כמעצת בלעם, והוא הוא רמז ה"י יתירה שבמלת אותכ"ה לדעתי שירמוז על ה' מלכי מדין הקשורים ודבוקים בך, זהו אותכה, אות"ך ה' שהם היו ג"כ נהרגים אותך, אתך לחיבור שביניכם:	NULL
Paaneach Raza, Balak 19	כי לא ידעתי וקשה א"כ לא הי"ל חטא, וי"ל דב"נ נהרג על שהי"ל ללמוד ולא למד, ה"נ הי"ל לידע ולהבין:	Numbers 22:34
Paaneach Raza, Balak 20	וירא משם קצה העם פי' ראה את כולם עד סוף המחנה כמו כל העם מקצה, וקשה איך עלה ע"ד לקללם הרי אין זעמו של הקב"ה אלא רגע, ורגע הוא כמימריה כדאיתא בגמ' וכן רגע בגימט' כאומרו ופשיטא דרגע עין לא יכול לקללם דמה יכול לדבר ברגע עין, וי"ל שיהי' יכול לומר כלם, ועי"ל שאין כונת שעת כעסו ית' צריכה אלא להתחלה ומשהתחיל יכול לקלל הרבה אף חוץ מרגע של זעמו, ותדע שהרי אמרו מברכותיו של אותו רשע וכו' בקש לומר וכו', הרי שדברים הרבה הי' רוצה לקלל מה שא"א לומר ברגע א', ג"ן:	Numbers 22:41
Paaneach Raza, Balak 21	שפ"י, בגימ' לפ"י כ"י הי"ה חיג"ר, שפ"י נוטריקון "שומר "פתאים "ה', כלומר ששמר ישראל מקללותיו, ויל"ך שפ"י בגימט' חיג"ר ברג"ל, כדאיתא במדרש בלעם חיגר ברגלו א' הי', דן בשתי רגליו דכתיב שפיפון עלי אורח (והענין שהמדרש דורש שפי מלשון שף מדוכתי' ושפיפון הוא בכפל:	NULL
Paaneach Raza, Balak 22	מן אדם ינחני בלק פי' להשפילני מרוממותי וממעלתי, כי כתיב ומקללך אאור והוא בקש ממני לקללם:	NULL
Paaneach Raza, Balak 23	מה אקוב לא קבה אל פי' מצד אברהם או יצחק הי' אפשר, מצד שנמצא פסול בזרעם כבר, אבל מצד יעקב הנקרא אל הדבר נמנע שמטתו שלימה והוא חבל נחלתו:	Numbers 23:8
Paaneach Raza, Balak 24	לבד"ד ישכו"ן בגימט' ובימ"י משי"ח:	Numbers 23:9
Paaneach Raza, Balak 25	ומספר את רבע ישראל לשון רבוע ע"ש ד' דגלים:	Numbers 23:10
Paaneach Raza, Balak 26	תמות נפשי מות ישרים כלומר הלואי שימות מיתה טבעית פשוטה ולא כאשר מעותד לבא עליו, מות ישרים מכאן מוכרח שכל ישראל יש להם חלק לעוה"ב דאל"כ מהלי מות ישרים או רשעים והרי הוא ברוה"ק דיבר:	Numbers 23:10
Paaneach Raza, Balak 27	מו"ת ישרי"ם בגימט' אבו"ת העול"ם:	Numbers 23:10
Paaneach Raza, Balak 28	ושרי מואב אתו, ואלו בתחלה כתיב וכל שרי מואב, אלא מכיון שראו בראשונה שבירכן הלכו להם קצתם:	Numbers 23:17
Paaneach Raza, Balak 29	ותרועת מלך בו, הוא רצה לקללם ולומר כלם כשיעור רגע כדלעיל ויהפך ה' את הקללה לברכה שאמר בהפך דהיינו מלך:	Numbers 23:21-22
Paaneach Raza, Balak 30	כתועפות ראם פי' כפלי כפלים בכח ראם, וכפלת מתרגמינן ותעיף:	Numbers 23:22-23
Paaneach Raza, Balak 31	כי לא נחש ביעקב לשון נסיון כמו נחשתי מתרגמינן נסיתי, וכלומר שאף אין לנסות אם יתרצה בוראם לקללם, כי בודאי אינו רוצה, ושמא תאמר ע"י כשפים יוכלו להם שמכחישים פמליא של מעלה זהו ולא קסם וגו':	Numbers 23:23
Paaneach Raza, Balak 32	כעת יאמר ליעקב פי' יבא עת וזמן שיאמר אל יעקב וישראל מה רוב טוב הפעולות פעל עם אלה:	Numbers 23:23
Paaneach Raza, Balak 33	ג"ן:	NULL
Paaneach Raza, Balak 34	ד"א כי לא נחש א"צ ניחוש כמוני כי כעת מחר ויומא חרא יאמר לו ע"י נביא מה פעל אל ית' (או כעת יאמר פי' תכף כעת כל פעל ופעל ה' יאמר ויוודע ליעקב ולישראל מיד ע"י נביאיהם, או כעת ר"ל בכל עת ועת:	NULL
Paaneach Raza, Balak 35	מדלי"ו, בגימט' מלך:	NULL
Paaneach Raza, Balak 36	וירם מאגג מלכו פי' מלכו הראשון יתפוס את אגג:	Numbers 24:7
Paaneach Raza, Balak 37	ודם חללים ישתה, מזה יעלילו המינין, ותשובה להם בזה, דה"ק הן עם כלביא וכארי, שהארי ולביא לא ישכב עד יאכל טרף ודם חללים ישתה, כך דמיון ישראל כשיקום על אויביו יעשם כלה לגמרי, לוי:	NULL
Paaneach Raza, Balak 38	ויודע דעת עליון, שאין דעתו לקללם:	Numbers 24:16
Paaneach Raza, Balak 39	נופל וגלוי עינים, בלילה נופל למשכב, וגלוי עינים ביום במראה, שאין לו צורך מראות הלילה כשאר הנביאים:	Numbers 24:16
Paaneach Raza, Balak 40	יחזה" נופל" וגלוי" עינים" ס"ת מיל"ה למפרע, שמפני שלא נימול לא עצר כח לעמוד בתקומה בעת שנדבר עמו, (ולכן האותיות בהיפוך ובס"ת שזה לו מפני שאף לבסוף בהיותו נביא גדול לא חש והפך לבו מלחוש במילה ונסוג אחור מלהמול) וכן באברהם מתחלה ויפול אברהם על פניו אבל אחר שנימול כתיב ואברהם עודנו עומד וגו':	Numbers 24:16
Paaneach Raza, Balak 41	אראנו ולא עתה, פי' עכשיו אל תירא מהם:	Numbers 24:17
Paaneach Raza, Balak 42	וירא את הקיני, אחר שנבא על ראש אויביהם הוא עמלק נבא על ראש אוהביהם הוא יתרו:	NULL
Paaneach Raza, Balak 43	קרק"ר, בא"ת ב"ש הוא בגימט' דוד:	NULL
Paaneach Raza, Balak 44	או"י מ"י יחי"ה משמ"ו א"ל בגימט' דימ"י [בימ"י] מל"ך המשי"ח, שכיון שראה שאז יכלו כל האומות התחיל מקונן עליהם אוי מי יחיה וגו' פי' שמחיה עצמו בשמות של הקב"ה מפני דאשתמש בתגא חלף, מהר"ר חיים:	Numbers 24:23
Paaneach Raza, Balak 45	בע"ל פעו"ר בגימט' צוא"ה פעו"ר:	Numbers 25:3
Paaneach Raza, Pinchas 1	@במדבר פרשת פינחס	NULL
Paaneach Raza, Pinchas 2	ובעזר אלהי לצור מחס, נתחיל סדר פינחס:	Numbers 25:11
Paaneach Raza, Pinchas 3	פינח"ס בגימט' ד"פ אליה"ו בשביל שאליהו עושה שליחות בד' טיסות כדאיתא בברכות, ואליהו הוא פינחס:	NULL
Paaneach Raza, Pinchas 4	פינח"ס בגימט' נחמ"ו נחמ"ו לומר שיבא לנחם ולבשר לישראל כדכתיב מה נאוו על ההרים וגו' וכתיב הנה אנכי שולח וגו' (פינח"ס בגימט' יצח"ק כי אחז במדה"ד היא מדתו של יצחק ועשה פלילות עם קונו ועשה דין ברשעים, ולכן בא פינחס מלא שלזה הטעם ניתנה לו היו"ד, ואולי הוא בעצמו הרמז בוי"ו דשלום קטיעה שבזה נדמית כיו"ד לומר הנני נותן לו וגו', שאני נותן לו אות יו"ד לכוין מספרו למספר יצחק מצד מדתו שאחז לעשות דין ברשעים אשר זהו בעצמו השלום כשנעשה בם דין, וגם ע"ד יש דין למטה אין דין למעלה):	NULL
Paaneach Raza, Pinchas 5	השיב את חמתי ואין לישראל לשנאתו על שהרג את זמרי כי טובה גדולה עשה עמהם:	NULL
Paaneach Raza, Pinchas 6	ולא כליתי את וגו' והרי פעולתו הטובה הזאת שעשה עמהם עשאה פרי ויצאת לפעל. וא"כ אף אם ישנאוהו על כך אין בכך כלום:	NULL
Paaneach Raza, Pinchas 7	הנני נותן לו וגו' שלא יירא גם מקרובי זמרי הנשיא וקרובי כזבי בת מלך:	Numbers 25:12
Paaneach Raza, Pinchas 8	בקנאו את קנאתי וגו', כפול הוא להורות שהוא הוא שקינא גם בימי אחאב כדאיתא במדרש וכן מטעם זה גם שם כתוב כפל קנא קנאתי לה' צבאות וגו' והרי מעשה דהכא קדם, הוא דבר הש"י שגלוי הי' לפניו שיקנא גם לעתיד, וכפל הלשון על כך, ושם במעשה המאוחר הוא מדברי אליהו עצמו שאמר הכפל בלשון עבר, קנאתי על שכבר קינא גם כאן:	Numbers 25:12
Paaneach Raza, Pinchas 9	את בריתי שלום, ו' זעירא בשביל שעד כאן לא נתכהן פנחס לענין זרעו כמאמר חז"ל לכן כתיב כמו יו"ד, שעי"כ התיבה הוא כמו שלים כלומר שעתה השלימה לו כהונתו:	Numbers 25:12
Paaneach Raza, Pinchas 10	ד"א כי י' דורות מפנחס עד שנסתלק אביתר הכהן אשר אז היתה הכהונה לזרעו של פנחס, ד"א נגד י' קנאות שבפרשת סוטה וגם הוא קנא, וכזבי היתה כמו סוטה, (ד"א בשביל שגם כאן בימי אחאב היתה קנאתו על הברית לשמרו בתקונו בקדושה וטהרה, כדאיתא במדרש שכשנחלקה המלכות לשתי מלכיות מנע אפרים ברית המילה מישראל, וכן כאן קנא על ששיקץ וטימא זמרי את הברית והחזירו לקלקולו כי ידענו שעי"כ הערלה נמשכת, והנה הוי"ו שהוא רמז והוראה על כלי המשגל כלי החבור במה שהיא היא אות החיבור וככל אשר זכרנו לעיל בענין ו' של יעקוב מלא, לכן נקטעת במקום הזה והועמדה על יו"ד לומר שקנאתו היתה על סילוק הערלה וקטיעת כלי המשגל המצווה מאתו ית' להחליש כח התאווני מלהכשל בעריות, ושצריך להעמיד הכלי הזה על יו"ד הקדושה שהיא היא רמז הברית, והנה ע"י בימי אחאב ע"י אפרים עברו בזה וכן כאן זמרי, ולכן לר"נ דאמר בקדושין פ' האומר ו' דשלום קטיעא הוא להורות שבעל מום פסול לעבודה כלומר כשהוא שלם ולא כשהוא חסר, אל יקשה לך אליבי' א"כ לא לכתוב ו' כלל, דודאי צריכה לכתוב להכי להורות ענין הקטיעא וכנזכר, ובודאי זהו הבעל מום העקרי המשקץ הברית. והוא ג"כ הטעם שבכל המקרא בא פינחס מלא ביו"ד בר מן חד דהיינו חפני ופנחס כהנים לה' (שמואל א' ג'), שהוא נמסר למערבאי חסר ולמדינחאי מלא אשר לדעתי הטעם כמו שיבואר, דהיינו, איתא בפ' במה בהמה א"ר, פנחס לא חטא וכו', ומסיק דאעפ"כ ובני עלי בני בליעל כיון שהי"ל לפינחס למחות לחפני ולא מיחה מעלה עליו הכתוב כאלו חטא גם הוא, הנה לטעם זה פנחס חסר למערבאי, לומר שחסרון הוא לו לפנחס הזה, ומה חסרונו, היו"ד, שהוא מלשון יד, כדאיתא באותיות דר' עקיבא, כלומר שמצד היד הי' חסר, שהי' בידו למחות ולא מיחה, ולמדינחאי מלא מהאי טעמא גופי' שהרי הי"ל יד למחות, ולפ"ז ל"פ מערבאי ומדינחאי, או אולי מערבאי לא ס"ל כתלמודא דידן וסברי דודאי פנחס ג"כ חטא לכן צ"ל חסר, ואולי מדינחאי הן הן בעלי תלמוד בבלי דאי"ל שלא חטא כנזכר לכן צ"ל מלא, או אולי בדרב ור' יונתן גופי' פליגי, דר' יונתן פליג התם אדרב ואית לי' דתרווייהו לא חטאו, דמקיש חפני לפנחס, הנה זו סברת מדינחאי שא"כ אין מקום כלל להיות פנחס חסר, ומערבאי סברי כרב דחפני הוא חטא ופנחס לא מיחה בידו כנזכר לכן צ"ל חסר):	Numbers 25:12
Paaneach Raza, Pinchas 11	הנני נותן לו את בריתי שלום תרגום יונתן ואעבדיני' מלאך קיים (והענין שלדעתו זהו שכתוב שלום ע"ד עושה שלום במרומיו):	Numbers 25:12
Paaneach Raza, Pinchas 12	נשיא בית אב וגו', וקשה דבפ' אלו הן הנשרפין אמרו ה' שמות הי' לו ומני בינייהו שלומיאל בן צורישדי א"כ הי' נשיא שבט ונשיא בית אב אינו נשיא שבט:	Numbers 25:14-15
Paaneach Raza, Pinchas 13	שלומיא"ל בגימטרי' ד"א זמר"י ב"ן סלו"א:	NULL
Paaneach Raza, Pinchas 14	לשמעני, חסר ו' שמכיון שנפל מהם הנשיא לא העמידו עוד מלך ושופט כדאיתא במדרש תדשא (ויתכן לזה חסרון אות ו' שהוא כמין חוטרא, רמז לשחסרו שבט המלכות שבט מוסר):	NULL
Paaneach Raza, Pinchas 15	ויהי אחרי המגפה וגו', פי' אחר שכלו מתי מדבר שצוה למנותן לידע הנשארים שילחמו בכנענים:	Numbers 26:1
Paaneach Raza, Pinchas 16	ובני פלוא אליאב, ובן מבע"ל ומיהו מצינו כן בכמה מקומות כמו ובני דן חושים ובני איתן עזריה שדרך האדם לומר על בנו בני:	Numbers 26:8-9
Paaneach Raza, Pinchas 17	משפחת השופמי, ע"ש דדרשינן יש פה, שלא גילה מכירת יוסף, לכן חיסר כאן פ"א שלא כתוב השפופמי ובדברי הימים קראו שפיפון, ע"ש נחש עלי דרך דאמרינן שמת בעטיו של נחש, הר"ר אליעזר:	Numbers 26:39
Paaneach Raza, Pinchas 18	ושם בת אשר סרח, כיון שהיתה מיוצאי מצרים מנאה כאן אבל קשה למה נקט לשון ושם ובת אשר מבע"ל, ועוד דתרגום מפרש ושום ברת אתת אשר סרח (פי' דהי' להם כך בתרגום כגירסת הרמב"ן) דמשמע שהיתה חורגתו ולא בתו, ואולי לפי שהוא גידלה אצלו נקראת על שמו, וזהו שאמר ושם בת אשר, כלומר אינה בתו באמת רק שנקראת בשם בת אשר, ועי"ל לפי שהיתה ידועה בשם טוב לחסידות ומעשים טובים, לכן אמר ושם, אבל לפי התרגום הי' קשה, גם אם לא היתה בתו למה לא הזכיר בת מי היא, (וי"ל דאף לפי התרגום ניחא לי' להזכירה על שם אשר משום שהיא ואשר הביאו ליעקב מתחלה את הבשורה כי עוד בנו יוסף חי, ע' בתרגום ירושלמי פ' ויחי בפ' מאשר שמנה לחמו ובתרגום יונתן בפ' שבכאן, ותמצא, ואולי הוא הי' ממהר ממצרים בהתוודע יוסף אליהם והביא הבשורה שמה לארץ כנען ובבואו מיהרה היא מביתו וקדמתה אותו להביא הבשורה אל יעקב עצמו כדי להשוות שני התרגומין האלה, ולכן אמר ושם, וניחא לי' נמי לקרא לייחסה על שמו מעל שם אביה):	Numbers 26:59
Paaneach Raza, Pinchas 19	אך בגורל תחלק הארץ, זהו לענין השבטים שהיו חולקים בשוה ביניהם אבל לבתי אבות ולגברים שבכל שבט עליהם כתיב לרב תרבה נחלתו וגו', שמי שי"ל הרבה בנים יטול יותר, ובזה מתיישבים הפסוקים שאינם סותרים אהדדי:	Numbers 26:59
Paaneach Raza, Pinchas 20	אשר ילדה אותה ללוי, זהו מקרא קצר שר"ל יוכבד בת לוי אשר ילדה אותה אשתו ללוי, אבל קשה אותה ל"ל, וי"מ דאיתא במדרש כי אשתו של לוי אותה שמה, מרבי, ג"ן:	Numbers 26:59
Paaneach Raza, Pinchas 21	(והמופת לזה שבכל הספרים המדוייקים לא נמצא מפיק ה"א במלת אות"ה, גם טעם תביר שתחת אותה להכרית המלה ממלת לוי מוכיח כן):	NULL
Paaneach Raza, Pinchas 22	כי בחטאו מת ובנים לא הי"ל פי' חטאו גרם לו דובנים זכרים לא הי"ל:	Numbers 27:3
Paaneach Raza, Pinchas 23	את קרבני לחמ"י, אותיות מלח"י שהמלח מקיים הקרבן כדכתיב על כל קרבנך תקריב מלח ולכן נוהגין לטבול פת ברכת מוציא במלח כי השלחן איתקש למזבח שגם הוא מכפר:	Numbers 27:19-20
Paaneach Raza, Pinchas 24	ושעיר עזים אחד לחטאת לה', מפני ששעיר ר"ח הוא השעיר הנזכר ראשון כתיב בו לה' שיהא לשם שמים, והוא הוראה לכולם, ולרבותינו דרך אחר בזה ידוע, ואמרם הביאו עלי כפרה וכו', פירושו שבזה תתנחם הלבנה על שמיעטתיה שמה שקבעתי ר"ח לכפרה על אסכרה שלא תפול, שהרי ברביעי הי' נופל בתינוקות כדאמרינן וברביעי היו מתענין וכו', וגם המאורות נתלו ברביעי שהרי ר"ח הראשון הי' ברביעי, וכן לדעת מ"ד ששעיר ר"ח מכפר על טומאת מקדש וקדשיו קבע בזה בר"ח ג"כ לנחם את הלבנה זהו הביאו עלי וכו', מרבי:	Numbers 28:15
Paaneach Raza, Pinchas 25	בכל השעירים כתיב לחטאת חוץ מבשל עצרת דכתיב בו שעיר עזים א' לכפר עליכם, מפני שאמר הקב"ה אם קבלתם עליכם עול מלכות שמים ועול תורה מעלה אני עליכם כאלו לא חטאתם מעולם, זהו לכפר עליכם:	Numbers 28:15
Paaneach Raza, Pinchas 26	בכולם כתיב והקרבתם עולה וגו', חוץ מבראש השנה דכתיב ועשיתם עולה, מפני שאמר הקב"ה אם תצאו זכאין בדין ביום ר"ה הוי כאלו בראתי ועשיתי אתכם ברי' חדשה:	NULL
Paaneach Raza, Pinchas 27	פרים בני בקר שלשה עשר, הרי הפרים הם ע' כנגד האומות כנודע והכבשים נכפלו באחרונה על הפרים, שביום השביעי הם ז' פרים וי"ד כבשים, כי הכבשים הם נגד ישראל, הנך נתמעטים והני עולים ומתכפלים וה' בירך את אחריתם למשנה, וק"ל:	Numbers 29:13
Paaneach Raza, Matot 1	@במדבר פרשת מטות	NULL
Paaneach Raza, Matot 2	ובעזר צוה אחרי רבים להטות, נתחיל סדר ראשי המטות:	NULL
Paaneach Raza, Matot 3	אל ראשי המטות נקט לשון זה מפני שכמו שהבעל מיפר כך החכם יכול להתיר ובידו להטות הנדר:	Numbers 30:2
Paaneach Raza, Matot 4	איש כי ידור וגו' סמך זה לפ' רגלים שלא יאחר נדרו יותר משלש רגלים, ד"א לומר שהרגלים נקבעים ע"פ ראשי המטות:	Numbers 30:2
Paaneach Raza, Matot 5	זה הדבר אשר צוה ה' וקשה היכן נצטוה משה על כך, וי"ל דלעיל כתיב אלה תעשו לה' במועדיכם לבד מנדריכם וגו' שאמר לו אז סתם דיני נדרים ונדבות שמדעתו של אדם, ועתה פי' להם משה חילוקי הדינים ההם כפי שנאמרו לו מפי הגבורה:	Numbers 30:2
Paaneach Raza, Matot 6	לא יחל דברו לא יאחר נדרו כמו וייחל עוד שבעת ימים:	Numbers 30:3
Paaneach Raza, Matot 7	איש"ה יקימנ"ו ואיש"ה יפרנ"ו בגימט' דכמ"ו הבע"ל מיפ"ר החכ"ם יתי"ר:	Numbers 30:14-15
Paaneach Raza, Matot 8	נקום נקמת ב"י וגו', נסמכה פרשה זו לפרשת נדרים לומר שמצוה לנדור בשעת צרה וסכנה:	Numbers 31:2
Paaneach Raza, Matot 9	מאת המדינים, ולא מאת המואבים כי הם עשו מיראה שמא יחשבו ישראל כי ארצם ארץ רפאים הוא ויבאו עליהם, ועוד מפני שהרי כבר לקחו ארצם מיד סיחון:	Numbers 31:2
Paaneach Raza, Matot 10	אחר תאסף וגו', לפי שנעלמה ממנו הלכה של המדינית שלא הרגה לכן נתלו חייו בנקמת המדינים:	Numbers 31:2-3
Paaneach Raza, Matot 11	אותם ואת פנחס, ומשה למה לא הלך לפי שנתגדל במדין ומשום בירא דשתית מיני':	Numbers 31:6
Paaneach Raza, Matot 12	ויקצף משה על פקודי החיל וגו', ותימה דעל פנחס ההולך עמם ושקול כנגד כולם הי' לו לכעוס, ועוד הלא יוכלו ישראל לומר שוגגין היינו ולא ידענו, וי"ל דזהו שכתוב לעיל בדברי משה לתת נקמת ה' במדין, והרי הקב"ה אמר נקום נקמת בני ישראל, אלא שמשה א"ל הדבר מתחלה ב' ענינים א"ל הקב"ה נקמת ה' ונקמת ב"י, נקמת ה' מן הנשים שהפקירו א"ע והביאום לזנות לע"ז ונקמת ב"י מן האנשים, מצאתי:	Numbers 31:14
Paaneach Raza, Matot 13	(ועי"ל דמש"ה אמר לתת נקמת ה' במדין ולא אמר במדינים כדי לכלול גם המדיניות נקבות, ואל תקשה א"כ מהיכן נצטוה הוא על כך הלא הש"י אמר לו מאת המדינים דמשמע ולא מדיניות, דמאת חזר וריבה את הנקבות ומשמע את הטפל למדינים דהיינו נשיהם, ולא ראה הוא ית' לומר ג"כ סתם ממדין לכלול כלהו בלשון זה כמשה, משום דלא יהיו נכללים גם הטף כנשים, ומשה נשמר בזה בייתור ויהיו על מדין ואח"כ לתת נקמת ה' וגו' לומר דבקצתם לא יתנו נקמתו רק שיהיו עליהם כלומר שיקחו אותם בשביל עצמם:	NULL
Paaneach Raza, Matot 14	הן הנה היו מלמד שהיו מכירין אותן שעברו בהם עבירה לומר זהו שנכשל בה פלוני ובזו פלוני:	Numbers 31:16
Paaneach Raza, Matot 15	וכל אשה יודעת איש פירש"י שהעבירום לפני הציץ, וכן יש בפ' הבא על יבמתו וקשה למה לא העבירם לפני הארון כמו בני רצפה כדאיתא בפ' הערל, וי"ל דלאו אורח ארעא מאחר דיכול לבדקן בענין אחר, ותימה דלמה הני דבני רצפה ובתולות דאנשי גלעד לא העבירום נמי לפני הציץ, וי"ל דכתיב בי' בציץ לרצון להם ולא לפורענותם של ישראל, מרבי:	NULL
Paaneach Raza, Matot 16	תתחטאו, ותימה למה לא צוה כן גבי מלחמת סיחון ועוג, וי"ל דהתם היו כל ישראל וטומאה הותרה בצבור אבל כאן הי' מיעוט, מהר"ר יחיאל:	NULL
Paaneach Raza, Matot 17	ד"א שסיחון ועוג באו עליהם והיו ישראל כמצילים א"ע ומסתמא לא נגעו בחלל אבל כאן באו הם על מדין, מהר"ר אהרן:	NULL
Paaneach Raza, Matot 18	וא"ת למה לא צוה הקב"ה גיעול הכלים בסיחון ועוג כמו במדין, וי"ל דבסיחון ועוג שהיו בכלל לא תחיה כל נשמה אפי' בשר נחירה הי' מותר להם משא"כ במדין ועי"ל דהתם לא נשאר מהם מי שהיו מבשלין בהם ולא היו הכלים בני יומן ובקל נתקנו אבל כאן הרבה נשארו ממדין שבישלו בהם ביומן:	Numbers 32:6-7
Paaneach Raza, Matot 19	וחמורים, וקשה למה לא נזכרו גמלים שהי' להם הרבה כדכתיב שפעת גמלים תכסך בכרי מדין, וגבי גדעון נמי כתיב ולגמליהם אין מספר, דבשלמא סוסים נוכל לומר שלא הי"ל, וי"ל דאף אם הי"ל סוסים וגמלים הרבה לא בא לחשבון, מפני שאין ראוי מהם לכהן, דאלו בחמורים כתיב ופטר חמור תפדה בשה:	NULL
Paaneach Raza, Matot 20	לכפר על נפשותינו, תימה למה הוצרכו לכפרה הלא במלחמה הותרה יפ"ת ושמא קלקלו בביאה, ועי"ל דלא הותרה יפ"ת עד ביאתם לארץ וזהו ונתנו ה' בידך ואז וראית בשביה וגו', והר"ר שמעון מיינבול"א תירץ דכיון דמלחמת מדין היתה על זנות ע"ד כזבי לא הותרה בזנות (ועי"ל דלפי הסברא לא הי' יצרם תקפם במלחמה זו עד שהי' צורך להתיר שמכיון שחיי משה נתלו בה היו כולם יראים וחרדים הרי גם בשביל זה כתיב וימסרו שנמסרו בע"כ וכפירש"י שם אלא שאעפ"כ אין אפוטרופוס לעריות לכן הוצרכו כפרה, א"נ דבשביל כך הי' לאסור כאן באמת אף יפ"ת):	NULL
Paaneach Raza, Matot 21	בלתי כלב בן יפונה וגו' וקשה הרי גם יאיר בן מנשה נכנס לארץ שנהרג לפני העי כדאמרינן [כשלשים וששה] איש זה יאיר בן מנשה ששקול כרובה של סנהדרין, ושמא י"ל כשנגזרה גזירה זו לא הי' בן כ' ועל יותר מבן כ' נאמר אם יראו האנשים וגו' בלתי וגו':	Numbers 32:12
Paaneach Raza, Matot 22	והנה קמתם תחת אבותיכם וגו', יש במדרש שא"ל הקב"ה וכי מפני שאלו חטאו אתה מזכיר שוכני עפר לרעה לך לקבריהם ובקש מהם מחילה, מכאן נוהגין לפסוק מחילה בקבר למדבר על שוכני עפר בפני עדה ויתוקן מעוותו, מהר"ר חיים:	Numbers 32:14
Paaneach Raza, Matot 23	מוסבות שם פי' תחלה נקראו ע"ש עמון ומואב, ואח"כ ע"ש סיחון ולבסוף ע"ש ישראל:	Numbers 32:38
Paaneach Raza, Masei 1	@במדבר פרשת מסעי	NULL
Paaneach Raza, Masei 2	ובעזר יחדיל מרשעים רוגז ושם ינוחו יגיעי, נתחיל סדר אלה מסעי:	Numbers 34:17
Paaneach Raza, Masei 3	ממחרת הפסח יצאו וגו' פירש"י בפ' בא בפסוק ויהי בעצם היום הזה וגו' שבט"ו בניסן יצאו, ותימה דבענין ביאתם לארץ כתיב ביהושע ויאכלו מעבור הארץ ממחרת הפסח, ואמרו בפ"ק דקדושין דזהו ט"ז בניסן לאחר שהביאו את העומר, א"כ ממחרת הפסח פי' למחרתו של יו"ט דהיינו ט"ז וכאן פי' למחרת אכילת קרבן פסח דהיינו ט"ו עצמו, וי"מ דאין מביאין ראי' מדברי קבלה על דברי תורה, טו"ב:	NULL
Paaneach Raza, Masei 4	ורבינו סעדיה פי' דגם כאן ממחרת הפסח הוי ט"ז בניסן, כלומר למחרתו של י"ט ראשון דהכי קאמר קרא, ויסעו מרעמסס וגו' בחמשה עשר וגו', דבט"ו יצאו מרעמסס סכותה ואח"כ אמר קרא ממחרת הפסח יצאו ב"י ביד רמה וגו', כלומר ואח"כ כשנקבצו כולם לסוכות יצאו ב"י לעיני כל מצרים ביד רמה:	NULL
Paaneach Raza, Masei 5	ובאלהיהם עשה ה' שפטים פי' בשופטיהם כי השופט נקרא אלהים ולכך לא כתיב ואלהיהם הכה דעשייה יתכן בשופטים:	NULL
Paaneach Raza, Masei 6	ויחנו באלוש, שם ירד להם מן בזכות שרה, וזה אלוש ע"ש לושי ועשי עוגות ושרה זו יסכ"ה בגימט' המ"ן:	NULL
Paaneach Raza, Masei 7	מנגב לקדש ברנע, תימה לרבינו בכור שור דעתה בא ליתן תחומי וגבולי ארץ כנען וא"כ משמע דקדש ברנע הוא בארץ כנען וזה אי אפשר דמשם שלח משה את המרגלים והרי הוא לא עבר את הירדן, ובפירוש כתיב בכלב בשלוח אותו משה מקדש ברנע, ועוד הרי בהר ההר מת אהרן כדכתיב לעיל בפרשה וגם הוא לא עבר את הירדן וכאן כתיב וזה יהי' לכם גבול צפון מן הים הגדול תתאו לכם הר ההר, ושמא י"ל דתרי קדש ברנע הוו שהרי בספר יהושע מונהו בעיירות שמעבר לירדן, וכן אמרו רבותינו דתרי קדש הוו כמו כן צ"ל בקדש ברנע, וגם רש"י פי' דתרי הר ההר הוו, ואותו של עבר הירדן הוא טורי אמנון המפורש בגיטין ובודאי מדוחק הכתובים פי' כן, ג"ן:	NULL
Paaneach Raza, Masei 8	למטה יהודה כלב בן יפונה ותימה דבכולם אמר נשיא חוץ מבשבט יהודה ושמעון ובנימין, וי"ל דבכולם כיון שכבר זכרו לנשיא בשלוח מרגלים והוא עמד כל ימיו בצדקו לא הוצרך עוד לקרותו נשיא, ובשמעון לא אמר נשיא משני טעמים א' שמכיון שחטא להם זמרי בן סלוא נשיא בית אב לא זכו להעמיד נשיא עוד כדכתיבנא לעיל בפ' פנחס על לשמעני חסר ו', ב' דאלו הנשיאים הוצרכו לחלוק הארץ ואין צורך נשיא לשמעון לכך דנחלתם היתה בתוך נחלת בני יהודה כדכתיב וינחלו בני שמעון נחלתם וגו', ובבנימין מפני שעתידין לחטוא בפילגש בגבעה לא זכו לקרא בהם נשיא לחלוקת הארץ (ולי נראה דמכיון שבא לספר בענין חלוקת הארץ לא רצו לקרא נשיא ליהודה מפני שמוכן הוא לגדולה מזו שהי' מעותד למלכות, וכן לשבט בנימין שאול מלך הראשון, ועוד שבגבול שניהם בנין בהמ"ק לשריית שכינה ובשמעון הטעם כנז'):	Numbers 34:19
Paaneach Raza, Masei 9	מקיר העיר וחוצה אלף אמה סביב ואח"כ פאת קדמה אלפים וגו', ועל פירש"י שפי' שהיו נותנין אלפים לכל רוח, אלף הפנימיים למגרש ועליהם אמר כאן אלף אמה סביב וחיצוניים לשדות וכרמים, קשה שהרי בסמוך על כל האלפיים אמר וזה יהי' לכם מגרשי הערים, אלא נראה לפ' דה"ק, מקיר העיר וחוצה אלף אמה סביב, כלומר שימדדו אותן אלף אמה בעיגול סביב העיר ואח"כ אמר ומדותם מחוץ לעיר את פאת קדמה אלפים וגו', כלומר שאח"כ ימדדו קוים ישרים:	Numbers 35:4
Paaneach Raza, Masei 10	עד מות הכהן הגדול, תלה הדבר דוקא במיתת הכהן הגדול, כדי שבצאתו של רוצח לא ירננו אחר הכ"ג על שאינו עושה נקמה בו בצאתו דעל הכ"ג הדבר מוטל כדכתיב ובאת אל הכהן אשר יהי' וגו', דלאפוקי אל הכהן שיקום אחריו אין לרנן אחריו דיאמרו מה לו ולצרה שלא היתה בימיו:	Numbers 35:28
